AADAM	AH AH D AE M
AADIL	AA D AH L
AAISHA	AA AH SH AH
AAISHAH	AA AH SH AH
AAKASH	AA K AH SH
AALIA	AA L Y AH
AALIYA	AH L IY AY AH
AALIYAH	AH L IY AY AH
AAMENA	AA M AH N AH
AAMENAH	AA M AH N AH
AAMINA	AA M AH N AH
AAMINAH	AA M AH N AH
AAMIR	AA M AH R
AAMIRAH	AA M AH R AH
AAMNA	AA M N AH
AANISAH	AA N AH S AH
AAQIB	AA K AH B
AARAN	AH AH R AE N
AARON	EH R AH N
AARONDEEP	AA R AH N D IY P
AARRON	AA R AH N
AARTI	AA R T IY
AARUN	AH AH R AH N
AASIM	AA S AH M
AATIF	AA T AH F
AATISH	AH EY T IH SH
ABAS	AE B AH Z
ABBAS	AH B AA S
ABBE	AE B IY
ABBE(2)	AE B EY
ABBEY	AE B IY
ABBEYGAIL	AE B AH G EY L
ABBI	AE B IY
ABBIE	AE B IY
ABBIE-LEIGH	AE B IY L IY
ABBIGAIL	AE B AH G EY L
ABBIGAYLE	AE B AH G EY L
ABBY	AE B IY
ABBYGAIL	AE B AH G EY L
ABD	AE B D
ABDAL	AE B D AH L
ABDALLAH	AE B D AE L AH
ABDEL	AE B D EH L
ABDI	AE B D IY
ABDINASIR	AE B D IH N AH S AH R
ABDIRAHMAN	AE B D IH R AH M AH N
ABDU	AE B D UW
ABDUL	AE B D UW L
ABDUL-AZEEZ	AE B D UW L EY Z IY Z
ABDULAZIZ	AE B D UW L AH Z IY Z
ABDULHAMID	AE B D AH L HH AH M AH D
ABDULKADIR	AE B D AH L K AH D AH R
ABDULLA	AA B D UW L AH
ABDULLAH	AE B D AH L AH
ABDULLAHI	AE B D AH L AH HH IY
ABDULRAHMAN	AE B D AH L R AH M AH N
ABDUR	AE B D AH R
ABDUR-RAHMAN	AE B D AH R R AA M AH N
ABDURAHMAN	AE B D Y UH R AH M AH N
ABEL	EY B AH L
ABHINAV	AE B HH AH N AH V
ABHISHEK	AE B HH AH SH AH K
ABI	AE B IY
ABID	EY B IH D
ABIDA	AE B AH D AH
ABIDUL	AE B AH D AH L
ABIGAEL	AE B AH G IY L
ABIGAIL	AE B AH G EY L
ABIGALE	AH B AY G EY L
ABIGAYLE	AE B AH G EY L
ABIOLA	AA B IY OW L AH
ABIR	AE B AH R
ABRAHAM	EY B R AH HH AE M
ABRAHIM	AE B R AH HH AH M
ABRAR	AE B R AH R
ABU	AE B UW
ABUBAKAR	AE B Y UW B AH K AH R
ABUL	AE B AH L
ABYGAIL	AE B AH G EY L
ACACIA	AH K EY SH AH
ACE	EY S
ACER	EY S ER
ADA	EY D AH
ADAEZE	AH D IY Z
ADAL	EY D AH L
ADAM	AE D AH M
ADAMA	AE D AH M AH
ADAN	EY D AH N
ADARSH	AE D AH R SH
ADDAM	AE D AH M
ADDISON	AE D AH S AH N
ADDISON(2)	AE D IH S AH N
ADEDAPO	AH D EH D AH P OW
ADEEB	EY D IY B
ADEEBA	EY D IY B AH
ADEEL	EY D IY L
ADEELA	EY D IY L AH
ADEKUNLE	AE D AH K Y UW N AH L
ADEL	AH D EH L
ADELAIDE	AE D AH L EY D
ADELE	AH D EH L
ADELLE	AH D EH L
ADEM	AE D AH M
ADEN	EY D AH N
ADEOLA	EY D IY AH L AH
ADHAM	AE D HH AE M
ADIBA	AE D AH B AH
ADIL	AE D AH L
ADINA	AA D IY N AH
ADNAAN	AE D N EY AH N
ADNAN	AE D N AH N
ADRIAN	EY D R IY AH N
ADRIANA	EY D R IY AE N AH
ADRIANNA	AE D R IY AE N AH
ADRIANNE	AE D R IY AH N
ADRIANO	AA D R IY AA N OW
ADRIEN	AH D R AY AH N
ADRIENNE	AA D R IY EH N
ADRIS	AH D R AY Z
AEDAN	EH D AH N
AERON	EH R AH N
AFIFA	AE F AH F AH
AFOLABI	AH F AA L AH B IY
AFRA	AE F R AH
AFRAH	AE F R AH
AFSANA	AE F S AH N AH
AFUA	AE F Y UW AH
AFZAL	AE F Z AH L
AGATHA	AE G AH TH AH
AGNES	AE G N IH S
AHAD	AE HH AH D
AHAMED	AH HH AE M D
AHARON	AE HH ER AA N
AHLAM	AE L AH M
AHMAD	AA M AA D
AHMED	AA M AH D
AHMED(2)	AA M EH D
AHMET	AE M AH T
AHSAN	AE Z AH N
AIDA	AY IY D AH
AIDAN	EY D AA N
AIDEN	EY D AH N
AIESHA	AY SH AH
AILEEN	AY L IY N
AILIS	EY L IY Z
AILISH	EY L IH SH
AILSA	EY L S AH
AIMAN	AY M AH N
AIME	EY M
AIMEE	EY M IY
AIMEN	EY M AH N
AIMIE	EY M IY
AINE	EY N
AINSLEY	EY N S L IY
AISHA	EY SH AH
AISHAH	EY SH AH
AISHIA	EY SH IY AH
AISHLING	EY SH L AH NG
AISLING	EY S L IH NG
AISLINN	EY S L IH N
AIYSHA	EY AH SH AH
AJAY	EH JH EY
AJMAL	AE JH M AH L
AKAASH	AE K AH SH
AKASH	AE K AH SH
AKBAR	AE K B ER
AKBAR(2)	AA K B AA R
AKEEB	EY K IY B
AKEEL	AH K IY L
AKEEM	EY K IY M
AKHIL	AE K AH L
AKHTAR	AE K T ER
AKIB	AE K AH B
AKIF	AE K AH F
AKIL	AE K AH L
AKILAH	AE K AH L AH
AKIM	AE K AH M
AKIRA	AH K IY R AH
AKLIMA	AE K L AH M AH
AKRAM	AE K R AH M
AKSA	AE K S AH
AKSHAY	AE K EY IY
AL	AE L
ALAA	AE L AH
ALAIN	AH L EY N
ALAINA	AH L EY N AH
ALAMIN	AH L AE M IH N
ALAN	AE L AH N
ALANA	AA L AE N AH
ALANAH	AE L AH N AH
ALANIS	AA L AA N IH S
ALANNA	AA L AA N AH
ALANNAH	AH L AE N AH
ALANTA	AH L AE N T AH
ALANYA	AH L AE N AY AH
ALARNA	AH L AA R N AH
ALASDAIR	AH L AE Z D AH AH R
ALASTAIR	AE L AH S T EH R
ALBA	AE L B AH
ALBANY	AO L B AH N IY
ALBERT	AE L B ER T
ALBERTA	AE L B ER T AH
ALBERTO	AE L B ER T OW
ALBIE	AO L B IY
ALBY	AE L B IY
ALDEN	AA L D AH N
ALEAH	EY L IY AH
ALEASHA	EY L IY SH AH
ALEC	AE L IH K
ALECIA	AH L IY SH IY AH
ALED	EY L D
ALEEM	EY L IY M
ALEEMA	EY L IY M AH
ALEENA	EY L IY N AH
ALEESHA	EY L IY SH AH
ALEISHA	EY L IY SH AH
ALEJANDRO	AA L EY Y AA N D R OW
ALEJANDRO(2)	AA L EY HH AA N D R OW
ALEKSANDER	AE L AH G Z AE N D ER
ALEKSANDER(2)	AE L AH K S AE N D ER
ALEKSI	AH L EH K S IY
ALENA	AA L EY N AH
ALESHA	AE L AH SH AH
ALESSANDRA	AE L EH S AE N D R AH
ALESSANDRO	AA L EY Z AA N D R OW
ALESSANDRO(2)	AA L AH S AE N D R OW
ALESSIA	AH L EH SH IY AH
ALESSIO	AH L EH S IY OW
ALETHEA	AE L AH TH IY AH
ALEX	AE L AH K S
ALEXA	AH L EH K S AH
ALEXANDA	AE L AH K S AE N D AH
ALEXANDER	AE L AH G Z AE N D ER
ALEXANDER(2)	AE L IH G Z AE N D ER
ALEXANDRA	AE L EH G Z AE N D R AH
ALEXANDRA(2)	AE L IH G Z AE N D R AH
ALEXANDRE	AE L IH K S AA N D ER
ALEXANDREA	AE L AH K S AE N D R IY AH
ALEXANDRIA	AE L AH G Z AE N D R IY AH
ALEXANDROS	AE L AH K S AE N D R AH Z
ALEXEI	AH L EH K S EY
ALEXI	AH L EH K S IY
ALEXIA	AH L EH K S IY AH
ALEXIS	AH L EH K S IH S
ALEXZANDER	AH L EH K S Z AE N D AH R
ALEYSHA	EY L EY SH AH
ALF	AE L F
ALFIE	AE L F IY
ALFRED	AE L F R AH D
ALFRED(2)	AE L F R IH D
ALI	AA L IY
ALIA	EY L Y AH
ALIAH	EY L AY AH
ALICAN	AH L IH S AH N
ALICE	AE L AH S
ALICE(2)	AE L IH S
ALICEA	AH L IH S IY AH
ALICIA	AH L IH SH AH
ALICJA	AH L IH K JH AH
ALIESHA	EY L IY SH AH
ALIM	AE L AH M
ALIMA	AA L IY M AH
ALINA	AH L IY N AH
ALISA	AH L IY S AH
ALISDAIR	AH L IH Z D AH AH R
ALISHA	AA L IY SH AH
ALISHIA	AH L IH SH IY AH
ALISIA	AH L IH ZH IY AH
ALISON	AE L IH S AH N
ALISSA	AH L IH S AH
ALISTAIR	AE L IH S T EH R
ALISTER	AE L IH S T ER
ALIVIA	AH L IH V IY AH
ALIX	AE L IH K S
ALIXANDRA	AE L AH K S AE N D R AH
ALIYA	EY L IY AY AH
ALIYAH	AH L IY AH
ALLAN	AE L AH N
ALLANA	AE L AH N AH
ALLANAH	AE L AH N AH
ALLEGRA	AA L EH G R AH
ALLEN	AE L AH N
ALLIE	AE L IY
ALLISON	AE L AH S AH N
ALLISON(2)	AE L IH S AH N
ALLISTER	AO L IH S T ER
ALLISTER(2)	AE L IH S T ER
ALLYSHA	AE L AH SH AH
ALLYSON	AE L IH S AH N
ALMA	AE L M AH
ALMA(2)	AO L M AH
ALMAS	AE L M AH Z
ALUN	EY L AH N
ALVARO	AH L V AA R OW
ALVIN	AE L V IH N
ALWYN	AE L W IH N
ALYCE	AE L IH S
ALYCIA	AH L IH SH IY AH
ALYS	AE L IY Z
ALYSHA	AE L AH SH AH
ALYSHIA	AH L IH SH IY AH
ALYSIA	AH L IH S IY AH
ALYSON	EY L IY S AH N
ALYSSA	AH L IH S AH
ALYSSIA	AH L IH SH IY AH
ALYX	AE L AH K S
AMAAD	AE M AH D
AMAAN	AE M EY AH N
AMAL	AH M AA L
AMALIA	AH M AA L Y AH
AMALIE	AE M AH L IY
AMAN	AA M AH N
AMANA	AH M AE N AH
AMANDA	AH M AE N D AH
AMANDEEP	AH M AE N D IY P
AMANI	AE M AH N IY
AMANPREET	AE M AH N P R IY T
AMANVEER	AH M AE N V IH ER
AMAR	AH M AA R
AMARA	AA M AA R AH
AMARAH	AE M AH R AH
AMARDEEP	AH M AA R D IY P
AMARI	AA M AA R IY
AMARJIT	AH M AA R JH AH T
AMARPAL	AH M AA R P AE L
AMARPREET	AE M AH R P R IY T
AMBA	AE M B AH
AMBAR	AE M B AH R
AMBER	AE M B ER
AMBER-LEIGH	AE M B ER L IY
AMBER-LOUISE	AE M B ER L UW IY Z
AMBER-ROSE	AE M B ER R OW Z
AMBERLEIGH	AE M B AH R L EY
AMBERLEY	AE M B AH R L IY
AMBREEN	AE M B R IY AH N
AMBROSE	AE M B R OW Z
AMEE	EY M IY IY
AMEEN	AH M IY N
AMEENA	EY M IY N AH
AMEENAH	EY M IY N AH
AMEER	EY M IH R
AMEERA	EY M AH R AH
AMELIA	AH M IY L Y AH
AMELIA-ROSE	AH M IY L Y AH R OW Z
AMELIE	AH M IY L AY
AMENA	AE M AH N AH
AMER	EY M ER
AMEY	EY M IY
AMI	AA M IY
AMIE	AE M IY
AMIEE	EY M IY IY
AMII	EY M IY
AMIN	AA M IY N
AMINA	AE M AH N AH
AMINAH	AE M AH N AH
AMINAT	AE M AH N AH T
AMINATA	AH M IH N AH T AH
AMINE	AH M AY N
AMINUR	AE M AH N AH R
AMIR	AH M IH R
AMIR(2)	AA M IH R
AMIRA	AE M AH R AH
AMIRAH	AE M AH R AH
AMISHA	AE M AH SH AH
AMIT	AA M IY T
AMJAD	AE M JH AH D
AMMAAR	AE M EY AH R
AMMAARAH	AE M AH R AH
AMMAR	AE M AH R
AMMARA	AE M AH R AH
AMMARAH	AE M AH R AH
AMMIE	AE M AY
AMNA	AE M N AH
AMNAH	AE M N AH
AMOS	EY M AH S
AMR	AA M ER
AMRAN	AE M R AH N
AMREEN	AE M R IY AH N
AMRIK	AE M R AH K
AMRIT	AE M R AH T
AMRITA	AE M R AH T AH
AMRITPAL	AE M R IH T AH L
AMY	EY M IY
AMY-JANE	EY M IY JH EY N
AMY-JAYNE	EY M IY JH EY N
AMY-JO	EY M IY JH OW
AMY-LEE	EY M IY L IY
AMY-LEIGH	EY M IY L IY
AMY-LOUISE	EY M IY L UW IY Z
AMY-ROSE	EY M IY R OW Z
AMYLEIGH	AE M AH L EY
ANA	AA N AH
ANA(2)	AE N AH
ANABEL	AE N AH B AH L
ANAIS	AE N EY AH S
ANAM	AE N AH M
ANAMIKA	AH N AE M AH K AH
ANAND	AE N AH N D
ANAS	AE N AH S
ANASTASIA	AE N AH S T EY ZH AH
ANASTASIOS	AE N AH S T EY S IY AH Z
ANDERS	AE N D ER Z
ANDERSON	AE N D ER S AH N
ANDI	AE N D IY
ANDIE	AE N D IY
ANDRE	AA N D R EY
ANDREA	AE N D R IY AH
ANDREA(2)	AA N D R EY AH
ANDREAS	AA N D R EY AH S
ANDREI	AE N D R EY
ANDRES	AA N D R EY Z
ANDRES(2)	AE N D R EY Z
ANDREW	AE N D R UW
ANDY	AE N D IY
ANEEKA	EY N IY K AH
ANEEL	EY N IY L
ANEELA	EY N IY L AH
ANEEQA	EY N IY K AH
ANEES	EY N IY Z
ANEESA	EY N IY S AH
ANEESAH	EY N IY S AH
ANEESHA	EY N IY SH AH
ANEIL	EY N IY L
ANEURIN	EY N Y UW R AH N
ANGEL	EY N JH AH L
ANGELA	AE N JH AH L AH
ANGELICA	AE N JH EH L IH K AH
ANGELICA(2)	AE N JH AH L IY K AH
ANGELINA	AE N JH EH L IY N AH
ANGELINE	EY NG G IH L AY N
ANGELINE(2)	AE N JH AH L IY N
ANGELO	AE N JH AH L OW
ANGELOS	AE N JH AH L OW Z
ANGHARAD	AE N AH R AH D
ANGIE	AE N JH IY
ANGUS	AE NG G AH S
ANIA	EY N Y AH
ANIKA	AE N AH K AH
ANIL	AE N AH L
ANILA	AE N AH L AH
ANIQA	AE N AH K AH
ANIQAH	AE N AH K AH
ANIS	EH N IY Z
ANISA	AE N AH S AH
ANISAH	AE N AH S AH
ANISH	EY N AH SH
ANISHA	AE N AH SH AH
ANISSA	AH N IH S AH
ANITA	AH N IY T AH
ANJA	AA N JH AH
ANJALI	AE N JH AH L IY
ANJANA	AE N JH AH N AH
ANJUM	AE N JH AH M
ANKIT	AE NG K AH T
ANKITA	AE NG K AH T AH
ANKUR	AE NG K AH R
ANMOL	AE N M AH L
ANN	AE N
ANN-MARIE	AE N M ER IY
ANNA	AE N AH
ANNA-LOUISE	AE N AH L UW IY Z
ANNA-MARIA	AE N AH M ER IY AH
ANNA-MARIE	AE N AH M ER IY
ANNA-ROSE	AE N AH R OW Z
ANNABEL	AE N AH B EH L
ANNABELL	AE N AH B AH L
ANNABELLA	AE N AH B EH L AH
ANNABELLE	AE N AH B AH L
ANNALEE	AE N AH L IY IY
ANNALIESE	AE N AH L IY Z
ANNALISA	AE N AE L AH S AH
ANNALISE	AE N AH L AY Z
ANNAM	AE N AH M
ANNE	AE N
ANNE-MARIE	AE N M ER IY
ANNEKA	AE N AH K AH
ANNELIESE	AE N AH L IY Z
ANNEMARIE	AE N EH M AH R AY
ANNETTE	AH N EH T
ANNICE	AE N AH S
ANNIE	AE N IY
ANNIE-MAY	AE N IY M EY
ANNIE-ROSE	AE N IY R OW Z
ANNIKA	AE N AH K AH
ANNISA	AE N AH S AH
ANNMARIE	AE N M AH R AY
ANOUSHKA	AH N AW SH K AH
ANOUSKA	AH N AW S K AH
ANSA	AE N S AH
ANTHEA	AE N TH IY AH
ANTHONIA	AE N TH OW N Y AH
ANTHONY	AE N TH AH N IY
ANTOINE	AA N T W AA N
ANTOINETTE	AE N T W AH N EH T
ANTON	AE N T AO N
ANTONELLA	AE N T AH N EH L AH
ANTONI	AA N T OW N IY
ANTONIA	AE N T OW N IY AH
ANTONIO	AE N T OW N IY OW
ANTONY	AE N T AH N IY
ANUJ	AE N AH JH
ANUM	AE N AH M
ANUSHA	AE N AH SH AH
ANWAR	AE N W AA R
ANWAR(2)	AA N W AA R
ANWEN	AE N W AH N
ANYA	AE N AY AH
AOIFE	EY OY F
APHRA	AE F R AH
APRIL	EY P R AH L
AQEEB	AH K IY B
AQEEL	AH K IY L
AQIB	AE K AH B
AQIL	AE K AH L
AQSA	AE K S AH
AQUIB	AE K W AH B
ARABELLA	AE R AH B EH L AH
ARAMINTA	AE R AH M IH N T AH
ARAN	EH R AH N
ARANDEEP	AH R AE N D IY P
ARANJIT	AH R AE N JH AH T
ARBAAZ	AA R B AH Z
ARCHIBALD	AA R CH AH B AO L D
ARCHIE	AA R CH IY
AREEBA	AH R IY B AH
ARFAN	AA R F AH N
ARI	AA R IY
ARIA	AA R IY AH
ARIAN	AE R IY AH N
ARIANA	AA R IY AE N AH
ARIANE	EH R IY AE N
ARIANNA	AA R IY AE N AH
ARIANNE	AE R IY AH N
ARIC	AE R IH K
ARIEL	EH R IY AH L
ARIELLA	AA R IY EH L AH
ARIELLE	AH R IY L
ARIF	AE R AH F
ARIFA	AE R AH F AH
ARJAN	AA R JH AH N
ARJUN	AA R JH AH N
ARLEN	AA R L AH N
ARMAAN	AA R M EY AH N
ARMAN	AA R M AH N
ARMAND	AA R M AH N D
ARMAND(2)	AA R M AA N D
ARMANI	AA R M AA N IY
ARMIN	AA R M AH N
ARMON	AA R M AH N
ARNIE	AA R N IY
ARNOLD	AA R N AH L D
ARON	EH R AH N
AROOJ	AH R UW JH
AROON	AH R UW N
AROOSA	AH R UW S AH
ARRAN	AE R AH N
ARRIE	AE R AY
ARRON	AE R AH N
ARRY	AA R IY
ARSALAAN	AA R S AE L EY AH N
ARSALAN	AA R S AH L AH N
ARSHAD	AA R SH AH D
ARSLAAN	AA R S L EY AH N
ARSLAN	AA R S L AH N
ARTHUR	AA R TH ER
ARUN	AH R AH N
ARUNDEEP	AH R AH N D IY P
ARUSA	AH R UW S AH
ARVINDER	AA R V AY N D AH R
ARWEL	AA R W AH L
ARYA	AE R AY AH
ARYAN	AA R IY AH N
ASA	AA S AH
ASAD	AH S AE D
ASAM	AE S AH M
ASH	AE SH
ASHA	AA SH AH
ASHANTI	AH SH AE N T IY
ASHER	AE SH ER
ASHFAQ	AE SH AH K
ASHIA	AE SH IY AH
ASHISH	AH SH IY SH
ASHLEA	AE SH L IY AH
ASHLEE	AE SH L IY
ASHLEIGH	AE SH L EY
ASHLEY	AE SH L IY
ASHLIE	AE SH L AY
ASHLYN	AE SH L AH N
ASHNA	AE SH N AH
ASHRAF	AE SH R AH F
ASHRAFUL	AE SH R AH F AH L
ASHTON	AE SH T AH N
ASHWIN	AE SH W IH N
ASIA	EY ZH AH
ASIF	AE S AH F
ASIM	AE S AH M
ASIYA	EY S IY AY AH
ASIYAH	EY S IY AY AH
ASLAM	AH S L AE M
ASLI	AE Z L IY
ASMA	AE Z M AH
ASMAA	AE Z M AH
ASSAD	AH S AA D
ASTON	AE S T AH N
ASTRA	AE S T R AH
ASTRID	AE S T R IH D
ATALANTA	AE T AH L AE N T AH
ATHENA	AH TH IY N AH
ATHINA	AE TH AH N AH
ATIF	AE T AH F
ATIYA	EY T IY AY AH
ATIYAH	EY T IY AY AH
ATIYYAH	EY T IY AY AY AH
ATLANTA	AE T L AE N T AH
ATLANTA(2)	AH T L AE N T AH
ATLANTA(3)	AE T L AE N AH
ATLANTA(4)	AH T L AE N AH
ATTIYA	AE T IY AY AH
AUBERON	AO B AH R AH N
AUBREY	AO B R IY
AUDREY	AO D R IY
AUGUSTA	AH G AH S T AH
AUGUSTIN	AW G UW S T IY N
AUGUSTINE	AA G AH S T IY N
AUGUSTINE(2)	AO G AH S T IY N
AUGUSTUS	AA G AH S T AH S
AUGUSTUS(2)	AH G AH S T AH S
AURELIA	AH R IY L Y AH
AURORA	ER AO R AH
AUSTEN	AO S T IH N
AUSTIN	AO S T AH N
AUSTYN	AO S T AH N
AUTUMN	AO T AH M
AVA	EY V AH
AVALON	AE V AH L AA N
AVI	AA V IY
AVI(2)	EY V IY
AVINASH	AE V AH N AH SH
AVNEET	AE V N IY T
AVNI	AE V N IY
AVRIL	AE V R IH L
AVRIL(2)	EY V R AH L
AVROHOM	AE V R AH HH AH M
AWAIS	AH W EY Z
AWEN	AO AH N
AXEL	AE K S AH L
AXL	AE K S L
AYA	EY AH
AYAH	EY AH
AYAN	EY AH N
AYANNA	EY AE N AH
AYAZ	EY AH Z
AYDAN	EY D AH N
AYDEN	EY D AH N
AYDIN	EY D IH N
AYEISHA	EY IY SH AH
AYESHA	EY AH SH AH
AYESHIA	EY EH SH IY AH
AYISHA	EY AH SH AH
AYLA	EY L AH
AYLISH	EY L AH SH
AYMAN	EY M AH N
AYODEJI	EY AA D AH JH IY
AYODELE	EY AH D IY L
AYOKUNLE	EY AH K Y UW N AH L
AYOMIDE	EY AH M AY D
AYOOLA	EY UW L AH
AYOUB	EY AW B
AYRTON	EY R T AH N
AYSE	EY Z
AYSHA	EY SH AH
AYUB	EY AH B
AYYUB	EY AY AH B
AZAD	AE Z AH D
AZARIA	AH Z AE R IY AH
AZEEM	EY Z IY M
AZEEZ	EY Z IY Z
AZHAR	AH Z AA R
AZIM	AE Z AH M
AZIZ	AH Z IY Z
AZIZA	AE Z AH Z AH
AZIZUR	AE Z AH Z AH R
AZRA	AE Z R AH
AZRAA	AE Z R AH
BABAJIDE	B AE B AH JH AY D
BABAR	B AA B AA R
BABATUNDE	B AE B AH T AH N D
BADEN	B EY D AH N
BAHAR	B AE AH R
BAILEY	B EY L IY
BALAL	B EY L AH L
BALDEEP	B IY AH L D IY P
BALRAJ	B AE L R AH JH
BAMIDELE	B AE M AH D IY L
BARAN	B AA R AA N
BARBARA	B AA R B ER AH
BARBARA(2)	B AA R B R AH
BARIS	B AA R IY Z
BARNABAS	B AA R N AH B AH S
BARNABY	B AA R N AH B IY
BARNEY	B AA R N IY
BARRIE	B AE R IY
BARRIE(2)	B EH R IY
BARRY	B AE R IY
BARRY(2)	B EH R IY
BARTHOLOMEW	B AA R TH AA L AH M Y UW
BASHIR	B AH SH IH R
BASIL	B AE Z AH L
BASIT	B AE S AH T
BAXTER	B AE K S T ER
BAYLEE	B EY L IY
BAYLEIGH	B EY L EY
BAYLEY	B EY L IY
BEATRICE	B IY AH T R AH S
BEATRICE(2)	B IY AH T R IH S
BEATRICE(3)	B IY T R AH S
BEATRICE(4)	B IY T R IH S
BEATRIX	B IY T R IH K S
BEATRIX(2)	B IY AH T R IH K S
BEAU	B OW
BECKI	B EH K IY
BECKIE	B EH K IY
BECKY	B EH K IY
BEGUM	B IH G AH M
BELAL	B EH L AH L
BELINDA	B AH L IH N D AH
BELLA	B EH L AH
BELLE	B EH L
BEN	B EH N
BENEDICT	B EH N AH D IH K T
BENITA	B AH N IY T AH
BENITO	B EH N IY T OW
BENITO(2)	B AH N IY T OW
BENITO(3)	B IH N IY T OW
BENJAMAN	B IH N JH EY M AH N
BENJAMEN	B IY AH N JH AE M AH N
BENJAMIN	B EH N JH AH M AH N
BENJIMAN	B IH N JH AY M AH N
BENN	B EH N
BENNY	B EH N IY
BENOIT	B AH N OY T
BENSON	B EH N S AH N
BENTON	B EH N T AH N
BEREN	B IY ER AH N
BERFIN	B IY ER F IH N
BERKAY	B IH R K EY IY
BERNADETTE	B ER N AH D EH T
BERNARD	B ER N AA R D
BERNARD(2)	B ER N ER D
BERNICE	B ER N IY S
BERTIE	B ER T IY
BERTRAM	B ER T R AH M
BESSIE	B EH S IY
BETH	B EH TH
BETHAN	B EH TH AH N
BETHANEY	B AH TH EY N IY
BETHANIE	B AH TH EY N AY
BETHANNIE	B AH TH AE N AY
BETHANY	B EH TH AH N IY
BETHANY-JANE	B EH TH AH N IY JH EY N
BETHANY-LOUISE	B EH TH AH N IY L UW IY Z
BETHANY-ROSE	B EH TH AH N IY R OW Z
BETHEN	B IY IH TH AH N
BETHENY	B IY IH TH AH N IY
BETHIA	B AH TH AY AH
BETHNEY	B EH TH N IY
BETSAN	B EH T S AH N
BETSY	B EH T S IY
BETTY	B EH T IY
BETUL	B AH T AH L
BEVAN	B EH V AH N
BEVERLEY	B EH V ER L IY
BEVERLY	B EH V ER L IY
BHAKTI	B HH AE K T IY
BHARAT	B HH AE R AH T
BHAVIK	B HH AE V AH K
BHAVIN	B HH AE V AH N
BHAVINI	B HH AE V AH N IY
BHAVISHA	B HH AE V AH SH AH
BHUPINDER	B HH Y UW P AY N D AH R
BIANCA	B IY AA NG K AH
BIBI	B IH B IY
BIBI(2)	B IY B IY
BIJAL	B AY JH AH L
BILAAL	B AY L EY AH L
BILAL	B AY L AH L
BILL	B IH L
BILLAL	B IH L AH L
BILLI	B AY L IY
BILLIE	B IH L IY
BILLIE-JEAN	B IH L IY JH IY N
BILLIE-JO	B IH L IY JH OW
BILLY	B IH L IY
BILLY-JOE	B IH L IY JH OW
BILLY-RAY	B IH L IY R EY
BILLYJOE	B AY L IH JH OW
BINYOMIN	B AY N AY AH M AH N
BJORN	B Y AO R N
BLADE	B L EY D
BLAIN	B L EY N
BLAINE	B L EY N
BLAIR	B L EH R
BLAISE	B L EY Z
BLAIZE	B L EY Z
BLAKE	B L EY K
BLANE	B L EY N
BLAYNE	B L EY N
BLEDDYN	B L EH D AH N
BLISS	B L IH S
BLOSSOM	B L AA S AH M
BLUE	B L UW
BLYTHE	B L AY DH
BOB	B AA B
BOBBI	B AA B IY
BOBBI-JO	B AA B IY JH OW
BOBBIE	B AA B IY
BOBBIE-JO	B AA B IY JH OW
BOBBY	B AA B IY
BODRUL	B AA D R AH L
BOLUWATIFE	B AH L AH W AH T AY F
BONITA	B OW N IY T AH
BONNIE	B AA N IY
BONNY	B AA N IY
BORIS	B AO R IH S
BOYD	B OY D
BRAD	B R AE D
BRAD-LEE	B R AE D L IY
BRADD	B R AE D
BRADEN	B R EY D AH N
BRADIE	B R AE D IY
BRADLEE	B R AE D L IY
BRADLEIGH	B R AE D L EY
BRADLEY	B R AE D L IY
BRADLY	B R AE D L IY
BRADY	B R EY D IY
BRAM	B R AE M
BRANDAN	B R AE N D AH N
BRANDEN	B R AE N D AH N
BRANDON	B R AE N D AH N
BRANDON-LEE	B R AE N D AH N L IY
BRANNON	B R AE N AH N
BRAYDEN	B R EY D EH N
BRAYDON	B R EY D AA N
BREANNA	B R IY N AH
BREE	B R IY
BRENDA	B R EH N D AH
BRENDAN	B R EH N D AH N
BRENDEN	B R EH N D AH N
BRENDON	B R EH N D AH N
BRENNA	B R EH N AH
BRENNAN	B R EH N AH N
BRENNEN	B R EH N AH N
BRENT	B R EH N T
BRENTON	B R EH N T AH N
BRET	B R EH T
BRETT	B R EH T
BRIA	B R IY AH
BRIAN	B R AY AH N
BRIANA	B R IY AE N AH
BRIANA(2)	B R IY AA N AH
BRIANNA	B R IY AE N AH
BRIANNE	B R AY AH N
BRIAR	B R AY ER
BRIDGET	B R IH JH AH T
BRIDGET(2)	B R IH JH IH T
BRIDIE	B R IH D IY
BRIGID	B R IH G AH D
BRIONY	B R AY AH N IY
BRITTANIE	B R IH T EY N AY
BRITTANY	B R IH T AH N IY
BRODIE	B R OW T IY
BRODY	B R OW D IY
BROGAN	B R OW G AH N
BROGEN	B R OW JH AH N
BRONAGH	B R AA N AH
BRONIA	B R OW N Y AH
BRONSON	B R AA N S AH N
BRONTE	B R AA N T IY
BRONWEN	B R AO N W IH N
BRONWYN	B R AA N W IH N
BRONYA	B R AA N AY AH
BROOK	B R UH K
BROOKE	B R UH K
BROOKLYN	B R UH K L AH N
BROOKLYN(2)	B R UH K L IH N
BRUCE	B R UW S
BRUNO	B R UW N OW
BRYAN	B R AY AH N
BRYANY	B R AY AH N IY
BRYCE	B R AY S
BRYCHAN	B R IH CH AH N
BRYDIE	B R IH D IY
BRYHER	B R IH AH R
BRYN	B R IH N
BRYNLEY	B R IH N L IY
BRYNMOR	B R IH N M AH R
BRYNN	B R IH N
BRYONI	B R AY AH N IY
BRYONIE	B R AY OW N AY
BRYONNY	B R AY AA N IY
BRYONY	B R AY AH N IY
BUDDY	B AH D IY
BURAK	B Y UW R AH K
BUSHRA	B AH SH R AH
BUSTER	B AH S T ER
BYRON	B AY R AH N
CADE	K EY D
CADIE	K EY D IY
CADY	K EY D IY
CAELAN	K IY L AH N
CAEN	K AE N
CAEN(2)	K AA N
CAI	K AY
CAILUM	K EY L AH M
CAIN	K EY N
CAINE	K EY N
CAIO	K EY OW
CAIRO	K AY R OW
CAIT	K EY T
CAITLAN	K EY T L AH N
CAITLIN	K EY T L IH N
CAITLYN	K EY T L AH N
CAITRIONA	K EY T R IY AH N AH
CAIUS	K EY AH S
CAL	K AE L
CALAM	K AE L AH M
CALAN	K EY L AH N
CALE	K EY L
CALEB	K EY L AH B
CALEM	K AE L AH M
CALEN	K EY L AH N
CALEY	K EY L IY
CALLAM	K AE L AH M
CALLAN	K AE L AH N
CALLEN	K AE L AH N
CALLIE	K AO L IY
CALLUM	K AE L AH M
CALLUMN	K AE L AH M
CALLUN	K AE L AH N
CALLY	K AE L IY
CALUM	K AE L AH M
CALVIN	K AE L V AH N
CALVIN(2)	K AE L V IH N
CALYPSO	K AH L IH P S OW
CAMARA	K AA M AA R AH
CAMDEN	K AE M D AH N
CAMERAN	K EY M R AE N
CAMERON	K AE M ER AH N
CAMILA	K AE M AH L AH
CAMILLA	K AH M IH L AH
CAMILLE	K AH M IY L
CAMPBELL	K AE M B AH L
CAMRAN	K AE M R AE N
CAMRON	K AE M R AH N
CAN	K AE N
CAN(2)	K AH N
CANAAN	K EY N AH N
CANDACE	K AE N D AH S
CANDICE	K AE N D IH S
CANER	K EY N ER
CAOIMHE	K EY OY M HH
CAOLAN	K EY AH L AH N
CAPRICE	K AH P R IY S
CARA	K EH R AH
CARAGH	K AE R AH
CAREY	K EH R IY
CARI	K AE R IY
CARIAD	K AE R IY AH D
CARINA	K AE R AH N AH
CARIS	K AE R IH S
CARISS	K EH R IY Z
CARISSA	K AA R IY S AH
CARL	K AA R L
CARLA	K AA R L AH
CARLEY	K AA R L IY
CARLI	K AA R L IY
CARLIE	K AA R L IY
CARLIN	K AA R L IH N
CARLO	K AA R L OW
CARLOS	K AA R L OW S
CARLTON	K AA R L T AH N
CARLY	K AA R L IY
CARMEL	K AA R M EH L
CARMEL(2)	K AA R M AH L
CARMELA	K AA R M EH L AH
CARMEN	K AA R M AH N
CARMINE	K AA R M AH N
CAROL	K AE R AH L
CAROL(2)	K EH R AH L
CAROL-ANN	K AE R AH L AE N
CAROLANNE	K AE R AH L AH N
CAROLE	K AE R AH L
CAROLE(2)	K EH R AH L
CAROLINA	K EH R AH L AY N AH
CAROLINE	K EH R AH L AY N
CAROLYN	K EH R AH L IH N
CARRIANNE	K AE R IY AH N
CARRICK	K EH R IH K
CARRIE	K EH R IY
CARRIE-ANN	K EH R IY AE N
CARRIE-ANNE	K EH R IY AE N
CARRIGAN	K AE R IH G AH N
CARRIS	K AE R IH S
CARSON	K AA R S AH N
CARSON(2)	K AA R Z AH N
CARTER	K AA R T ER
CARWYN	K AA R W AH N
CARY	K EH R IY
CARYL	K EH R AH L
CARYS	K EH R IY Z
CASEY	K EY S IY
CASHEL	K AE SH AH L
CASIE	K EY S IY
CASPAR	K AE S P ER
CASPAR(2)	K AE S P AA R
CASPER	K AE S P ER
CASSANDRA	K AH S AE N D R AH
CASSEY	K AE S IY
CASSIA	K AE SH IY AH
CASSIAN	K AE S IY AH N
CASSIDY	K AE S IH D IY
CASSIE	K AE S IY
CASSIUS	K AE S AY AH S
CATARINA	K AH T AE R AH N AH
CATHAL	K AE TH AH L
CATHARINE	K AE TH R IH N
CATHERINE	K AE TH ER AH N
CATHERINE(2)	K AE TH ER IH N
CATHERINE(3)	K AE TH R IH N
CATHRINE	K AE TH R AY N
CATHRYN	K AE TH R AH N
CATHY	K AE TH IY
CATRIN	K AE T R AH N
CATRINA	K AE T R AH N AH
CATRIONA	K AE T R IY AH N AH
CAVAN	K EY V AH N
CAYLEM	K EY L AH M
CAYLUM	K EY L AH M
CEARA	S IY R AH
CECELIA	S IH S IY L Y AH
CECIL	S IY S AH L
CECILE	S IH S IY L
CECILIA	S IH S IY L Y AH
CECILY	S EH S AH L IY
CEDRIC	S EH D R IH K
CEDRIC(2)	S IY D R IH K
CEEJAY	S IY JH EY IY
CEIRAN	S IY R AH N
CEIRON	S IY R AH N
CELESTE	S AH L EH S T
CELIA	S IY L Y AH
CELINA	S AH L IY N AH
CELINE	S AH L IY N
CELLAN	S EH L AH N
CELYN	S EH L AH N
CEM	S EH M
CENK	S EH NG K
CEREN	S IY R AH N
CERI	S EH R IY
CERI-ANN	S EH R IY AE N
CERIAN	S IY R IY AH N
CERIDWEN	S AH R IH D W AH N
CERISE	S ER IY S
CERYS	S EH R AH Z
CEYDA	S EY D AH
CEYHUN	S EY HH AH N
CEYLAN	S EY L AH N
CHACE	CH EY S
CHAD	CH AE D
CHADD	CH AE D
CHADLEY	CH AE D L IY
CHAE	CH AY
CHAIM	HH AY IH M
CHANA	CH AE N AH
CHANCE	CH AE N S
CHAND	CH AE N D
CHANDLER	CH AE N D L ER
CHANDNI	CH AE N D N IY
CHANEL	SH AH N EH L
CHANELL	CH AE N AH L
CHANELLE	CH AE N AH L
CHANICE	CH AE N AH S
CHANISE	CH AH N AY Z
CHANNEL	CH AE N AH L
CHANNELLE	CH AE N AH L
CHANNON	CH AE N AH N
CHANTAL	CH AE N T AH L
CHANTAY	CH AE N T EY IY
CHANTE	CH AE N T
CHANTEL	CH AE N T AH L
CHANTELE	CH AE N T IY L
CHANTELL	CH AE N T AH L
CHANTELLE	CH AE N T AH L
CHARALAMBOS	CH AA R AH L AA M B OW S
CHARELLE	CH AE R AH L
CHARIS	CH AA R IY Z
CHARISSE	CH AE R AH S
CHARITY	CH EH R IH T IY
CHARLEA	CH AA R L IY AH
CHARLEE	CH AA R L IY
CHARLEEN	CH AA R L IY N
CHARLEIGH	CH AA R L EY
CHARLENE	SH AA R L IY N
CHARLES	CH AA R L Z
CHARLES(2)	CH AA R AH L Z
CHARLEY	CH AA R L IY
CHARLEY-ANN	CH AA R L IY AE N
CHARLI	CH AA R L IY
CHARLIE	CH AA R L IY
CHARLIE-ANN	CH AA R L IY AE N
CHARLIE-ANNE	CH AA R L IY AE N
CHARLOTTE	SH AA R L AH T
CHARLOTTE-LOUISE	SH AA R L AH T L UW IY Z
CHARLTON	CH AA R L T AH N
CHARLY	CH AA R L IY
CHARMAINE	SH AA R M EY N
CHAS	CH AA R L Z
CHAS(2)	CH AA Z
CHASE	CH EY S
CHAUDHARY	CH AH D EH R IY
CHAY	CH EY IY
CHAYA	CH EY AH
CHAZ	CH AE Z
CHE	CH EY
CHELCIE	CH EH L S AY
CHELSEA	CH EH L S IY
CHELSEA-MARIE	CH EH L S IY M ER IY
CHELSEE	CH EH L S IY IY
CHELSEY	CH EH L Z IY
CHELSI	CH EH L S IY
CHELSIE	CH EH L S AY
CHELSY	CH EH L Z IY
CHENELLE	CH EH N AH L
CHENICE	CH IY N AH S
CHENISE	CH AH N AY Z
CHERELLE	CH EH R AH L
CHERI	SH EH R IY
CHERIE	SH EH R IY
CHERISE	CH AH R AY Z
CHERISH	CH EH R IH SH
CHERISSE	CH EH R AH S
CHERRELLE	CH EH R AH L
CHERRIE	CH EH R AY
CHERRY	CH EH R IY
CHERYL	SH EH R AH L
CHESTER	CH EH S T ER
CHETAN	CH IY T AH N
CHEY	CH IY IY
CHEYANNE	CH EY AH N
CHEYENNE	SH AY AE N
CHI	K AY
CHIAMAKA	CH AY AE M AH K AH
CHIARA	K Y AA R AH
CHIKE	CH AY K
CHINA	CH AY N AH
CHIOMA	CH AY AH M AH
CHIRAG	CH IH R AH G
CHLOE	K L OW IY
CHLOE-ANN	K L OW IY AE N
CHLOE-ANNE	K L OW IY AE N
CHLOE-JAYNE	K L OW IY JH EY N
CHLOE-LOUISE	K L OW IY L UW IY Z
CHLOE-MARIE	K L OW IY M ER IY
CHLOEE	K L OW IY IY
CHRIS	K R IH S
CHRISSIE	K R IH S IY
CHRISTA	K R IH S T AH
CHRISTABEL	K R IH S T AH B AH L
CHRISTIAN	K R IH S CH AH N
CHRISTIAN(2)	K R IH S CH IH N
CHRISTIANA	K R IH S T IY AE N AH
CHRISTIANNA	K R IH S T IY AE N AH
CHRISTIE	K R IH S T IY
CHRISTINA	K R IH S T IY N AH
CHRISTINE	K R IH S T IY N
CHRISTOPHER	K R IH S T AH F ER
CHRISTOS	K R IH S T AH Z
CHRISTY	K R IH S T IY
CHRYSTAL	K R IH S T AH L
CHUKWUEMEKA	CH AH K W UW EH M AH K AH
CHUN	CH AH N
CHYNA	CH IH N AH
CHYNNA	CH IH N AH
CIAN	SH IY N
CIARA	S AY AH R AH
CIARAN	S AY AH R AH N
CIAREN	S AY AH R AH N
CIARON	S AY AH R AH N
CICELY	S IH S AH L IY
CIERA	S IY R AH
CIERAN	S IY R AH N
CILLIAN	S IH L IY AH N
CINDY	S IH N D IY
CLAIR	K L EH R
CLAIRA	K L AE AH R AH
CLAIRE	K L EH R
CLARA	K L AE R AH
CLARA(2)	K L EH R AH
CLARE	K L EH R
CLARENCE	K L EH R AH N S
CLARICE	K L ER IY S
CLARISSA	K L ER IH S AH
CLARISSE	K L AE R IH S
CLARISSE(2)	K L AH R IY S
CLARK	K L AA R K
CLARKE	K L AA R K
CLAUDE	K L AO D
CLAUDETTE	K L OW D EH T
CLAUDIA	K L AO D IY AH
CLAUDIO	K L AO D IY OW
CLAY	K L EY
CLAYTON	K L EY T AH N
CLEA	K L IY
CLEMENT	K L EH M AH N T
CLEMENTINE	K L EH M AH N T AY N
CLEMENTINE(2)	K L EH M AH N T IY N
CLEO	K L IY OW
CLIFFORD	K L IH F ER D
CLINT	K L IH N T
CLINTON	K L IH N T AH N
CLIONA	K L AY AH N AH
CLIVE	K L AY V
CLODAGH	K L AA D AH
CLOE	K L OW
CLYDE	K L AY D
COBI	K OW B IY
COBIE	K OW B IY IY
COBY	K OW B IY
CODEY	K OW D IY
CODI	K OW D IY
CODIE	K OW D AY
CODY	K OW D IY
COHEN	K OW AH N
COLBY	K OW L B IY
COLE	K OW L
COLEEN	K AO L IY N
COLETTE	K OW L EH T
COLIN	K OW L IH N
COLLEEN	K AA L IY N
COLLETTE	K AH L EH T
COLM	K OW L M
COLT	K OW L T
COLTON	K OW L T AH N
COLUM	K OW L AH M
COMFORT	K AH M F ER T
CONAGH	K AH N AE
CONAH	K AH N AE
CONAL	K OW N AH L
CONALL	K AH N AO L
CONAN	K OW N AH N
CONAR	K OW N ER
CONER	K OW N ER
CONNA	K AA N AA
CONNAGH	K AA N AE
CONNAH	K AA N AE
CONNAIRE	K AA N AH AY ER
CONNAL	K AA N AH L
CONNALL	K AA N AO L
CONNAR	K AA N ER
CONNEL	K AA N EH L
CONNELL	K AA N AH L
CONNER	K AA N ER
CONNIE	K AO N IY
CONNOR	K AA N ER
CONOR	K OW N ER
CONRAD	K AA N R AE D
CONSTANCE	K AA N S T AH N S
CONSTANTINE	K AA N S T AH N T IY N
CONSTANTINE(2)	K AA N S T AH N T AY N
CONSTANTINOS	K AA N S T AH N T IY N OW S
CORA	K AO R AH
CORAL	K AO R AH L
CORALIE	K AO R AH L IY
CORAN	K OW R AE N
CORBIN	K AO R B IH N
CORDELIA	K AA R D IY L Y AH
CORDELL	K AO R D EH L
COREY	K AO R IY
CORI	K OW R IY
CORIE	K OW R IY
CORIN	K OW R IH N
CORINA	K AO R IY N AH
CORINNA	K AO R IH N AH
CORINNE	K ER IY N
CORMAC	K AO R M AH K
CORNELIUS	K AO R N IY L Y AH S
CORRAN	K AO R AH N
CORRIE	K AO R IY
CORRIN	K AO R IH N
CORRINA	K ER IY N AH
CORRINE	K AA R AY N
CORTNEY	K AO R T N IY
CORY	K AO R IY
COSIMA	K OW S IY M AH
COSMO	K AO Z M OW
COURTENAY	K ER T AH N EY
COURTENAY(2)	K AO R T N EY
COURTENEY	K OW AH R T IY N IY
COURTNEE	K OW AH R T N IY IY
COURTNEY	K AO R T N IY
COURTNEY-LOUISE	K AO R T N IY L UW IY Z
COURTNIE	K OW AH R T N AY
CRAIG	K R EY G
CRESSIDA	K R EH S AH D AH
CRISPIN	K R IH S P IH N
CRISTAL	K R IH S T AH L
CRISTIAN	K R IH S AH N
CRISTIANO	K R IY S T IY AA N OW
CRISTINA	K R IH S T IY N AH
CRYSTAL	K R IH S T AH L
CULLAN	K AH L AH N
CULLEN	K AH L AH N
CULLUM	K AH L AH M
CURRAN	K ER AH N
CURTIS	K ER T AH S
CURTIS(2)	K ER T IH S
CY	S AY
CYDNEE	S IH D N IY IY
CYDNEY	S IH D N IY
CYNTHIA	S IH N TH IY AH
CYRIL	S IH R AH L
CYRUS	S AY R AH S
D'ARCY	D AA R S IY
DAANISH	D AA N AH SH
DAANYAAL	D AH N AY EY AH L
DAENA	D IY N AH
DAFYDD	D AE F AH D
DAIN	D EY N
DAINA	D EY N AH
DAIRE	D AE AH R
DAISEY	D EY S IY
DAISIE	D EY AH S IY
DAISY	D EY Z IY
DAISY-MAE	D EY Z IY M EY
DAISY-MAY	D EY Z IY M EY
DAKOTA	D AH K OW T AH
DALE	D EY L
DALEY	D EY L IY
DALIA	D AA L Y AH
DALIAN	D EY L IY AH N
DALTON	D AO L T AH N
DALVIN	D AE L V AH N
DAMANI	D AE M AH N IY
DAMIAN	D EY M IY AH N
DAMIEN	D EY M IY AH N
DAMILOLA	D AH M IH L AH L AH
DAMINI	D AE M AH N IY
DAMION	D EY M IY AH N
DAMON	D EY M AH N
DAN	D AE N
DANA	D EY N AH
DANAE	D AE N IY
DANAH	D AE N AH
DANE	D EY N
DANI	D AA N IY
DANIA	D EY N Y AH
DANIAAL	D EY N Y AH AH L
DANIAL	D EY N IY AH L
DANICA	D AE N IH K AH
DANIEL	D AE N Y AH L
DANIELA	D AE N Y EH L AH
DANIELE	D AE N Y EH L
DANIELLA	D AE N Y EH L AH
DANIELLE	D AE N IY EH L
DANIELLE(2)	D AE N Y EH L
DANIKA	D AE N AH K AH
DANISH	D EY N IH SH
DANISHA	D AE N AH SH AH
DANIYAAL	D EY N IY AY EY AH L
DANIYAL	D EY N IY AY AH L
DANNI	D AE N IY
DANNIE	D AE N IY
DANNIELLA	D AE N IY L AH
DANNIELLE	D AE N IY L
DANNII	D AE N IY
DANNY	D AE N IY
DANTE	D AA N T EY
DANYA	D AE N AY AH
DANYAAL	D AH N AY EY AH L
DANYAL	D AE N AY AH L
DANYELLE	D AE N AY AH L
DARA	D AE R AH
DARAGH	D AE R AH
DARBY	D AA R B IY
DARCEY	D AA R S IY
DARCI	D AA R S IY
DARCIE	D AA R K IY
DARCY	D AA R S IY
DARIAN	D AE R IY AH N
DARIEN	D EH R IY AH N
DARIO	D EH R IY OW
DARION	D EH R IY AH N
DARIUS	D ER AY AH S
DARNEL	D AA R N AH L
DARNELL	D AA R N EH L
DARRAGH	D EH R AH
DARRAN	D AE R AH N
DARREL	D EH R AH L
DARRELL	D EH R AH L
DARREN	D AA R AH N
DARRIAN	D AE R IY AH N
DARRON	D AE R AH N
DARRYL	D EH R AH L
DARSHAN	D AA R SH AH N
DARWIN	D AA R W IH N
DARYL	D EH R AH L
DARYLL	D AE R AH L
DAUD	D AO D
DAULTON	D AO L T AH N
DAVEY	D EY V IY
DAVIAN	D EY V IY AH N
DAVID	D EY V IH D
DAVIDE	D AH V IY D EY
DAVIE	D EY V IY
DAVIN	D AE V IH N
DAVINA	D AA V IY N AH
DAVINDER	D AH V AY N D AH R
DAVY	D EY V IY
DAWN	D AO N
DAYLE	D EY L
DAYNA	D EY N AH
DAYNE	D EY N
DEACON	D IY K AH N
DEAN	D IY N
DEANA	D IY AE N AH
DEANE	D IY N
DEANNA	D IY AE N AH
DEANNE	D IY AE N
DEBBIE	D EH B IY
DEBORAH	D EH B ER AH
DEBORAH(2)	D EH B R AH
DEBRA	D EH B R AH
DECKLAN	D EH K L AH N
DECLAN	D IY K L AE N
DECLAND	D IH K L AE N D
DEE	D IY
DEEANNA	D IY IY N AH
DEEJAY	D IY EH JH EY IY
DEENA	D IY AH N AA
DEEP	D IY P
DEEPAK	D IY P AE K
DEION	D IY Y AA N
DEION(2)	D IY AA N
DEKLAN	D EH K L AH N
DEL	D EH L
DELANEY	D AH L EY N IY
DELIA	D IY L Y AH
DELLA	D EH L AH
DELPHINE	D EH L F IY N IY
DELYTH	D AH L IH TH
DEMELZA	D AH M EH L Z AH
DEMETRA	D AH M EH T R AH
DEMETRI	D AH M EH T R IY
DEMETRIUS	D IH M IY T R IY AH S
DEMI	D EH M IY
DEMI-LEA	D EH M IY L IY
DEMI-LEE	D EH M IY L IY
DEMI-LEIGH	D EH M IY L IY
DEMI-LOUISE	D EH M IY L UW IY Z
DEMI-MARIE	D EH M IY M ER IY
DEMILEE	D IY M AY L IY
DEMILEIGH	D AH M IH L EY
DEMMI	D IH M IY
DEMPSEY	D EH M P S IY
DENA	D IY N AH
DENE	D AH N IY
DENHAM	D EH N AH M
DENHOLM	D EH N HH OW L M
DENI	D AH N IY
DENIM	D EH N AH M
DENIRO	D IH N IH R OW
DENIS	D EH N IH S
DENISE	D IH N IY S
DENIZ	D EY N IY Z
DENNI	D IH N IY
DENNIS	D EH N IH S
DENNY	D EH N IY
DENVER	D EH N V ER
DENZEL	D EH N Z AH L
DENZIL	D EH N Z AH L
DEON	D IY AA N
DEREECE	D IH R IY IY S
DEREK	D EH R IH K
DERI	D AH R IY
DERICE	D IY R AY S
DERMOT	D ER M AH T
DERREN	D EH R AH N
DERRICK	D EH R IH K
DERRON	D IH R AA N
DERRY	D EH R IY
DERRYN	D IH R IH N
DERVLA	D IH R V L AA
DERYA	D AH R AY AH
DERYN	D AH R IH N
DESIREE	D EH S AY R IY
DESMOND	D EH Z M AH N D
DESTINY	D EH S T AH N IY
DEV	D EH V
DEVAN	D EH V AH N
DEVANTE	D AH V AE N T
DEVEN	D IY V AH N
DEVIN	D EH V IH N
DEVINA	D AH V IH N AH
DEVLIN	D EH V L IH N
DEVON	D EH V AH N
DEVONTE	D AH V AA N T
DEVORAH	D AH V AO R AH
DEVYN	D AH V IH N
DEWAN	D UW AH N
DEWI	D AH W IY
DEXTER	D EH K S T ER
DHANYAL	D HH AE N AY AH L
DHAVAL	D HH EY V AH L
DHILAN	D HH AY L AH N
DHILLON	D IH L AH N
DHIREN	D HH AY R AH N
DHRUV	D HH R AH V
DIANA	D AY AE N AH
DIANE	D AY AE N
DIEGO	D IY EY G OW
DIETER	D IY T ER
DILAN	D AY L AH N
DILARA	D IH L AH R AH
DILEN	D AY L AH N
DILESH	D IH L AH SH
DILLAN	D IH L AH N
DILLON	D IH L AH N
DILPREET	D IH L P R IY T
DILRAJ	D IH L R AH JH
DIMITRI	D IH M IY T R IY
DIMITRIOS	D IH M IY T R IY OW S
DIMITRIS	D AH M IH T R AH S
DINA	D IY N AH
DINAH	D AY N AH
DINESH	D IH N EH SH
DINO	D IY N OW
DION	D AY AH N
DION(2)	D IY AO N
DIONE	D IY AA N
DIONNE	D IY AA N
DIPESH	D IH P AH SH
DIQUAN	D IH K W AH N
DIVA	D IY V AH
DIVINE	D IH V AY N
DIVYA	D IH V AY AH
DJANGO	JH AE N G OW
DOLLY	D AA L IY
DOLORES	D AH L AO R IH S
DOMENIC	D OW M AH N IH K
DOMENICA	D AH M EH N AH K AH
DOMENICO	D OW M EY N IY K OW
DOMINIC	D AA M AH N IH K
DOMINICA	D AH M IH N IH K AH
DOMINICK	D AA M AH N IH K
DOMINIK	D AH M IH N IH K
DOMINIQUE	D AO M IH N IY K
DOMONIC	D AA M AH N AH K
DONAL	D AA N AH L
DONALD	D AA N AH L D
DONELL	D AA N AH L
DONNA	D AA N AH
DONNELL	D AA N IH L
DONOVAN	D AA N AH V AH N
DORA	D AO R AH
DORCAS	D AO R K AH S
DOREEN	D AO R IY N
DORIAN	D AO R IY AH N
DOROTHY	D AO R AH TH IY
DOROTHY(2)	D AO R TH IY
DOUGAL	D UW G AH L
DOUGLAS	D AH G L AH S
DOVID	D AH V AH D
DRE	D AH R
DREW	D R UW
DRU	D R UW
DUAINE	D Y UW EY N
DUANE	D W EY N
DUDLEY	D AH D L IY
DUKE	D UW K
DULCIE	D AH L K IY
DUNCAN	D AH NG K AH N
DURRELL	D AO R AH L
DUY	D UW IY
DWAYNE	D W EY N
DWIGHT	D W AY T
DYFAN	D AY F AH N
DYLAN	D IH L AH N
DYLLAN	D IH L AH N
DYLON	D IH L AH N
EAMON	IY M AH N
EAMONN	IY M AH N
EARL	ER L
EATHAN	IY TH AH N
EBEN	EH B AH N
EBENEZER	EH B IH N IY Z ER
EBONI	EH B AH N IY
EBONIE	AH B OW N AY
EBONY	EH B AH N IY
EBRAHIM	EH B R AH HH AH M
EBRU	EH B R UW
ECHO	EH K OW
EDA	IY D AH
EDAN	IY D AH N
EDDIE	EH D IY
EDDY	EH D IY
EDEN	IY D AH N
EDGAR	EH D G ER
EDIE	EH D IY
EDISON	EH D IH S AH N
EDITH	IY D IH TH
EDIZ	EH D AH Z
EDMUND	EH D M AH N D
EDNA	EH D N AH
EDOUARD	EH D UW AA R D
EDSON	EH D S AH N
EDUARDO	EH D W AA R D OW
EDWARD	EH D W ER D
EDWIN	EH D W AH N
EDWIN(2)	EH D W IH N
EDWINA	EH D W IY N AH
EDWYN	EH D W AH N
EFFIE	EH F IY
EHLANA	EH L AH N AH
EHSAN	EH Z AH N
EIBHLIN	IY B HH L AH N
EILEEN	AY L IY N
EILIDH	IY L AH D
EILIS	IY AH L AH S
EILISH	IY AH L AH SH
EIMEAR	IY M IY AH R
EIRA	IY R AH
EKATERINA	EY K AA T EH R IY N AH
EKTA	EH K T AH
EKUNDAYO	AH K AH N D EY OW
ELA	EH L AH
ELAIN	AH L EY N
ELAINA	IH L EY N AH
ELAINE	IH L EY N
ELAINE(2)	AH L EY N
ELAINE(3)	IY L EY N
ELAN	IY L AH N
ELANA	EH L AH N AH
ELANOR	EY L AA N ER
ELEANA	IY L IY N AH
ELEANOR	EH L AH N AO R
ELEANOR(2)	EH L AH N ER
ELEANORE	EH L AH N AO R
ELEASHA	IY L IY SH AH
ELEESHA	IY L IY SH AH
ELEISHA	IY L IY SH AH
ELEN	IY L AH N
ELENA	EH L AH N AH
ELENA(2)	EH L EY N AH
ELENI	EH L AH N IY
ELENYA	AH L EH N AY AH
ELERI	EH L AH R IY
ELGAN	EH L G AH N
ELHAM	EH L HH AH M
ELI	IY L AY
ELIANA	IY L IY AH N AH
ELIAS	AH L AY AH S
ELICIA	AH L IH SH IY AH
ELIEZER	IY L IY Z AH R
ELIF	EH L AH F
ELIJAH	EH L AY JH AH
ELIJAH(2)	IY L AY JH AH
ELIN	EH L AH N
ELINA	EH L AH N AH
ELINOR	EH L IH N ER
ELIOT	EH L IY AH T
ELIOTT	EH L IY AA T
ELIS	IY L AH S
ELISA	AH L IY S AH
ELISA(2)	AH L IY Z AH
ELISABETH	IH L IH Z AH B IH TH
ELISE	AH L IY S
ELISHA	EH L IH SH AH
ELISHEVA	AH L IH SH AH V AH
ELISHIA	AH L IH SH IY AH
ELISIA	AH L IH ZH IY AH
ELISSA	EH L IY S AH
ELIZA	IH L AY Z AH
ELIZABETH	IH L IH Z AH B AH TH
ELIZABETH(2)	IH L IH Z AH B IH TH
ELLA	EH L AH
ELLA-LOUISE	EH L AH L UW IY Z
ELLE	EH L
ELLEANOR	EH L IY N AH R
ELLEE	EH L IY IY
ELLEN	EH L AH N
ELLENA	EH L EH N AH
ELLENOR	EH L AH N AH R
ELLESE	EH L IY Z
ELLESHA	EH L AH SH AH
ELLESSE	EH L EH S
ELLEY	EH L IY
ELLI	EH L IY
ELLICE	EH L IH S
ELLICIA	EH L IH SH IY AH
ELLIE	EH L IY
ELLIE-JANE	EH L IY JH EY N
ELLIE-LOUISE	EH L IY L UW IY Z
ELLIE-MAE	EH L IY M EY
ELLIE-MARIE	EH L IY M ER IY
ELLIE-MAY	EH L IY M EY
ELLIE-ROSE	EH L IY R OW Z
ELLIEMAE	EH L AH M IY
ELLINOR	EH L AH N AH R
ELLIOT	EH L IY AH T
ELLIOTT	EH L IY AH T
ELLIS	EH L IH S
ELLISE	EH L AY Z
ELLISHA	EH L AH SH AH
ELLISIA	EH L IH ZH IY AH
ELLISON	EH L IH S AH N
ELLOISE	EH L OY Z
ELLOUISE	EH L AW AY Z
ELLY	EH L IY
ELLY-MAY	EH L IY M EY
ELLYS	EH L AH Z
ELLYSE	EH L AY Z
ELODIE	AH L OW D AY
ELOISA	EH L OY S AH
ELOISE	IH L OY Z
ELOISE(2)	EH L OW IY Z
ELOUISE	EH L AH W IY Z
ELSA	EH L S AH
ELSIE	EH L S IY
ELSPETH	EH L S AH TH
ELVIS	EH L V IH S
ELY	IY L AY
ELYSE	EH L AY S
ELYSHA	EH L AH SH AH
ELYSHIA	AH L IH SH IY AH
ELYSIA	IH L IH ZH IY AH
ELYSIA(2)	IH L IY ZH AH
ELYSSIA	AH L IH SH IY AH
EMAD	IY M AE D
EMAN	IY M AH N
EMANUEL	IH M AE N Y UW AH L
EMELIA	AH M IY L Y AH
EMELYE	AH M EH L AY
EMER	IY M AH R
EMERALD	EH M R AH L D
EMERALD(2)	EH M ER R AH L D
EMERSON	EH M ER S AH N
EMIL	EH M IY L
EMILE	EY M IY L
EMILEE	IY M AH L IY IY
EMILIA	AH M IY L IY AH
EMILIE	EH M AH L IY
EMILIO	AH M IY L IY OW
EMILLIE	IH M IH L AY
EMILLY	IH M IH L IY
EMILY	EH M IH L IY
EMILY-JANE	EH M IH L IY JH EY N
EMILY-JAYNE	EH M IH L IY JH EY N
EMILY-LOUISE	EH M IH L IY L UW IY Z
EMILY-MAY	EH M IH L IY M EY
EMILY-ROSE	EH M IH L IY R OW Z
EMINE	AH M IH N
EMLYN	IH M L IH N
EMMA	EH M AH
EMMA-JANE	EH M AH JH EY N
EMMA-JAYNE	EH M AH JH EY N
EMMA-LEIGH	EH M AH L IY
EMMA-LOUISE	EH M AH L UW IY Z
EMMANUEL	IH M AE N Y UW AH L
EMMANUELA	IH M AE N Y UW AH L AH
EMMANUELLA	IH M AE N Y UW EH L AH
EMMANUELLE	IH M AE N Y UW AH L
EMMELINE	EH M AH L AY N
EMMETT	EH M IH T
EMMIE	EH M IY
EMMY	EH M IY
EMRE	IH M R IY
EMYR	IH M Y R
ENES	IY N Z
ENIOLA	AH N AY AH L AH
ENRICO	EH N R IY K OW
ENYA	IH N Y AA
ENZO	EH N Z OW
EOGHAN	IY AH AH N
EOIN	IY OY N
EPHRAIM	IY F R AH M
ERAM	EH R AH M
ERAY	IH R AH IY
EREN	IY R AH N
ERIC	EH R IH K
ERICA	EH R IH K AH
ERIK	EH R IH K
ERIKA	EH R IH K AH
ERIN	EH R IH N
ERINN	EH R AH N
ERNEST	ER N AH S T
ERNEST(2)	ER N IH S T
ERNIE	ER N IY
EROL	EH R AH L
ERRAN	EH R AH N
ERROL	EH R AH L
ERYN	EH R AH N
ESHA	EH SH AH
ESHAN	EH SH AH N
ESHE	EH SH
ESME	EH Z M
ESMEE	EH Z M IY IY
ESRA	EH Z R AH
ESTA	EH S T AH
ESTELLE	EH S T EH L
ESTHER	EH S T ER
ETHAN	IY TH AH N
ETIENNE	EH T IY EH N
EUAN	Y UW AH N
EUGENE	Y UW JH IY N
EUGENIE	Y UW JH IY N IY
EUNICE	Y UW N AH S
EUNICE(2)	Y UW N IH S
EUPHEMIA	Y UW F IY M IY AH
EVA	EY V AH
EVA(2)	IY V AH
EVAN	EH V AH N
EVANDER	IY V AE N D ER
EVANGELINE	IH V AE N JH IH L AY N
EVE	IY V
EVELINA	EH V EH L IY N AH
EVELYN	EH V AH L AH N
EVELYN(2)	EH V AH L IH N
EVIE	IY V IY
EWAN	Y UW AH N
EWEN	Y UW AH N
EZEKIEL	EH Z IH K IY L
EZGI	EH Z IY
EZME	EH Z M
EZRA	EH Z R AH
FAAIZA	F AA AH Z AH
FAAIZAH	F AA AH Z AH
FAARIA	F AA R IY AH
FAATIMA	F AA T AH M AH
FAATIMAH	F AA T AH M AH
FABIAN	F EY B IY AH N
FABIEN	F AE B IY N
FABIENNE	F EY B IY N
FABIHA	F AE B AH HH AH
FABIO	F AA B IY OW
FABRIZIO	F AA B R IY T S IY OW
FAE	F AY
FAHAD	F AE HH AH D
FAHEEM	F AH HH IY M
FAHEEMA	F AH HH IY M AH
FAHEMA	F AE HH AH M AH
FAHID	F AE HH AH D
FAHIM	F AE HH AH M
FAHIMA	F AE HH AH M AH
FAHMIDA	F AE M AH D AH
FAISAL	F EY Z AH L
FAITH	F EY TH
FAIZ	F EY Z
FAIZA	F EY Z AH
FAIZAAN	F EY Z EY AH N
FAIZAH	F EY Z AH
FAIZAN	F EY AY Z AH N
FALAK	F AE L AH K
FALLON	F AE L AH N
FARAAZ	F AE R AH Z
FARAH	F EH R AH
FARAN	F AE R AH N
FARAZ	F AE R AH Z
FARHA	F AA R HH AH
FARHAAN	F AA R EY AH N
FARHAD	F AA R AH D
FARHAN	F AA R AH N
FARHANA	F AA R AH N AH
FARHAT	F AA R HH AE T
FARHEEN	F AA R IY AH N
FARID	F EH R AH D
FARIDA	F AE R AH D AH
FARIDAH	F AE R AH D AH
FARIHA	F AE R AH HH AH
FARIS	F EH R IH S
FARJANA	F AA R JH AH N AH
FARON	F EH R AH N
FAROOQ	F AE R AH K
FARRAH	F EH R AH
FARRELL	F EH R IH L
FARREN	F EH R AH N
FARRIS	F EH R IH S
FARYAL	F EH R IY AH L
FARZANA	F AA R Z AH N AH
FATEHA	F AE T AH HH AH
FATEMA	F AE T AH M AH
FATEMAH	F AE T AH M AH
FATHEMA	F AE TH AH M AH
FATHIMA	F AE TH AH M AH
FATIMA	F AE TH IH M AH
FATIMA(2)	F AE T IH M AH
FATIMAH	F AE TH IH M AH
FATMA	F AE T M AH
FATUMA	F AE T Y UW M AH
FAWAD	F AO AH D
FAWAZ	F AO AH Z
FAY	F EY
FAYE	F EY
FAYSAL	F EY Z AH L
FAZAL	F EY Z AH L
FEDERICO	F EH D ER IY K OW
FELICIA	F AH L IY SH AH
FELICITY	F IH L IH S AH T IY
FELIPE	F AH L IY P
FELIX	F IY L IH K S
FENELLA	F EH N EH L AH
FENTON	F EH N T AH N
FERDINAND	F ER D IH N AE N D
FERDINAND(2)	F ER D IH N AE N
FERGAL	F AH R G AH L
FERGUS	F ER G AH S
FERHAT	F EH R AH T
FERN	F ER N
FERNANDO	F ER N AE N D OW
FERNANDO(2)	F ER N AA N D OW
FERNE	F AH R N
FFION	F AY AH N
FIDEL	F IH D EH L
FILIP	F IH L IH P
FILIPE	F AH L AY P
FILIPPO	F IH L IY P OW
FINBAR	F IH N B AA R
FINBARR	F IH N B AH R
FINDLAY	F IH N D L IY
FINIAN	F IH N IY AH N
FINLAY	F IH N L IY
FINLEY	F IH N L IY
FINN	F IH N
FINNIAN	F IH N IY AH N
FINOLA	F IH N AH L AH
FINTAN	F IH N T AE N
FIONA	F IY OW N AH
FIONN	F AY AH N
FIONNUALA	F AY AH N Y UW AH L AH
FIRAS	F IH R AH Z
FIRAT	F IH R AH T
FIRDAUS	F AH R D EY AH S
FLAVIA	F L AE V IY AH
FLETCHER	F L EH CH ER
FLEUR	F L ER
FLORA	F L AO R AH
FLORENCE	F L AO R AH N S
FLORIAN	F L AO R IY AH N
FLORRIE	F L AO R IY
FLOYD	F L OY D
FLYNN	F L IH N
FOLASADE	F AA L AH S EY D
FOLASHADE	F AA L AH SH EY D
FORD	F AO R D
FORIDA	F AO R AH D AH
FORREST	F AO R AH S T
FOUZIA	F AW Z IY AH
FOX	F AA K S
FOZIA	F OW Z IY AH
FRANCES	F R AE N S IH S
FRANCESCA	F R AE N CH EH S K AH
FRANCESCO	F R AE N CH EH S K OW
FRANCESSCA	F R AE N S EH S AH
FRANCHESCA	F R AE NG K EH S AH
FRANCINE	F R AE N S IY N
FRANCIS	F R AE N S AH S
FRANCIS(2)	F R AE N S IH S
FRANCISCO	F R AE N S IH S K OW
FRANCOIS	F R AA N S W AA
FRANK	F R AE NG K
FRANKIE	F R AE NG K IY
FRANKLIN	F R AE NG K L IH N
FRASER	F R EY Z ER
FRASIER	F R EY ZH ER
FRAZER	F R EY Z ER
FRAZIER	F R EY ZH ER
FRED	F R EH D
FREDA	F R EH D
FREDDIE	F R EH D IY
FREDDY	F R EH D IY
FREDERIC	F R EH D R IH K
FREDERICA	F R EH D ER IY K AH
FREDERICK	F R EH D R IH K
FREDERICK(2)	F R EH D ER IH K
FREDERIK	F R EH D AH R AH K
FREDRIC	F R EH D R IH K
FREDRICK	F R EH D R IH K
FREDRIK	F R EH D R AH K
FREJA	F R EH JH AH
FREYA	F R EY AH
FREYJA	F R EY JH AH
FUAD	F Y UW AH D
FURQAN	F AH R K AH N
FYNN	F IH N
GABRIEL	G EY B R IY AH L
GABRIELA	G AA B R IY EH L AH
GABRIELE	G AA B R IY EH L
GABRIELLA	G AA B R IY EH L AH
GABRIELLE	G AE B R IY EH L
GABY	G AE B IY
GAGAN	G EY G AH N
GAGANDEEP	G AE G AH N D IY P
GAGE	G EY JH
GAIA	G AY AH
GAIL	G EY L
GARETH	G EH R IH TH
GARIN	G EH R IH N
GARION	G AE R IY AH N
GARRETT	G AE R IH T
GARRETT(2)	G EH R IH T
GARRICK	G EH R IH K
GARRY	G AE R IY
GARRY(2)	G EH R IY
GARTH	G AA R TH
GARY	G EH R IY
GARY(2)	G AE R IY
GARYN	G AE R AH N
GAURAV	G AO R AH V
GAVIN	G AE V IH N
GAVINDEEP	G AE V AH N D IY P
GAYLE	G EY L
GAYNOR	G EY N ER
GED	G EH D
GED(2)	JH IY IY D IY
GEENA	G IY N AH
GEMMA	JH EH M AH
GENE	JH IY N
GENEVA	JH AH N IY V AH
GENEVIEVE	JH EH N AH V IY V
GENNA	JH EH N AH
GENO	JH IY N OW
GEOFFREY	JH EH F R IY
GEORDIE	JH IY ER D IY
GEORGA	JH IY AO R G AH
GEORGE	JH AO R JH
GEORGEA	JH IY AO R JH IY AH
GEORGENA	JH IY AO R JH AH N AH
GEORGES	JH AO R JH AH Z
GEORGES(2)	JH AO R JH IH Z
GEORGETTE	JH AO R JH EH T
GEORGI	JH IY AA R JH IY
GEORGIA	JH AO R JH AH
GEORGIA-LEIGH	JH AO R JH AH L IY
GEORGIA-LOUISE	JH AO R JH AH L UW IY Z
GEORGIA-MAE	JH AO R JH AH M EY
GEORGIA-MAY	JH AO R JH AH M EY
GEORGIANA	JH AO R JH IY AE N AH
GEORGIE	JH AO R JH IY
GEORGINA	JH AO R JH IY N AH
GEORGIO	JH AO R JH IY OW
GEORGIOS	JH IY AO R JH IY AH Z
GERAINT	JH AH R EY N T
GERALD	JH EH R AH L D
GERALDINE	JH EH R AH L D IY N
GERARD	JH ER AA R D
GERRY	JH EH R IY
GERWYN	JH AH R W AH N
GETHIN	JH EH TH AH N
GETHYN	JH EH TH AH N
GHAZI	G AE Z IY
GHULAM	G Y UW L AE M
GIACOMO	JH AA K AH M OW
GIAN	JH IY AA N
GIANLUCA	JH AY AH N L UW K AH
GIANNA	JH AY AE N AH
GIANNI	JH AA N IY
GIANNI(2)	JH IY AA N IY
GIANNI(3)	JH Y AA N IY
GIDEON	G IH D IY AH N
GIL	G IH L
GILBERT	G IH L B ER T
GILES	JH AY L Z
GILLIAN	JH IH L IY AH N
GINA	JH IY N AH
GINO	JH IY N OW
GIORGIA	JH AO R JH AH
GIORGIO	JH AO R JH IY OW
GIOVANNA	JH AY AH V AE N AH
GIOVANNI	JH IY OW V AA N IY
GIOVANNI(2)	JH AH V AA N IY
GISELLE	ZH IH S EH L
GITTEL	JH IH T AH L
GITTY	JH IH T IY
GIULIA	JH AY UW L Y AH
GIUSEPPE	JH IH S EH P IY
GIZEM	JH IH Z AH M
GLEN	G L EH N
GLENN	G L EH N
GLESNI	G L EH Z N IY
GLORIA	G L AO R IY AH
GLYN	G L IH N
GLYNN	G L IH N
GORDON	G AO R D AH N
GOVIND	G AH V AY N D
GRACE	G R EY S
GRACIE	G R EY S IY
GRADY	G R EY D IY
GRAEME	G R EY M
GRAEME(2)	G R AE M
GRAHAM	G R EY AH M
GRAHAM(2)	G R AE M
GRAHAME	G R AH HH EY M
GRAINNE	G R EY N
GRANT	G R AE N T
GREG	G R EH G
GREGG	G R EH G
GREGOR	G R EH G ER
GREGORY	G R EH G ER IY
GRETA	G R IY T AH
GRIFFIN	G R IH F IH N
GRIFFITH	G R IH F AH TH
GRIFFITH(2)	G R IH F IH TH
GRUFFUDD	G R AH F AH D
GRUFFYDD	G R AH F AH D
GUILLAUME	G IH L AW M
GUILLAUME(2)	G W IY L OW M
GULAM	G Y UW L AH M
GULED	G Y UW L D
GULSEN	G AH L Z AH N
GURCHARAN	G AH R CH AH R AH N
GURDEEP	G AH R D IY P
GURDEV	G AH R D AH V
GURINDER	G Y AH R AY N D AH R
GURJEEVAN	G AH R JH IY V AH N
GURJINDER	G AH R JH AY N D AH R
GURJIT	G AH R JH AH T
GURKIRAN	G AH R K AH R AH N
GURKIRAT	G AH R K AH R AH T
GURMINDER	G AH R M AY N D AH R
GURPAL	G AH R P AH L
GURPREET	G AH R P R IY T
GURSHARAN	G AH R SH AH R AH N
GURSHARON	G AH R SH AH R AH N
GURSIMRAN	G AH R S IH M R AH N
GURVEER	G AH R V IH R
GURVINDER	G AH R V AY N D AH R
GURVIR	G AH R V AH R
GUS	G AH S
GUSTAVO	G AH S T AA V OW
GUTO	G Y UW T OW
GUY	G AY
GWAWR	G W AO R
GWEN	G W EH N
GWENAN	G W IY N AH N
GWENLLIAN	G W EH N L IY AH N
GWENNAN	G W EH N AH N
GWENNO	G W EH N OW
GWILYM	G W IH L AH M
GWION	G W AY AH N
GWYDION	G W AY D IY AH N
GWYN	G W IH N
GWYNETH	G W IH N AH TH
HAARIS	HH AA R AH S
HAAROON	HH AH R UW N
HABEEB	HH AE B IY B
HABEEBA	HH EY B IY B AH
HABEEBAH	HH EY B IY B AH
HABIB	HH AH B IY B
HABIBA	HH AE B AH B AH
HADASSAH	HH AH D AE S AH
HADEN	HH EY D AH N
HADLEY	HH AE D L IY
HADYN	HH AE D AH N
HAFEEZ	HH EY F IY Z
HAFIZA	HH AE F AH Z AH
HAFSA	HH AE F S AH
HAFSAH	HH AE F S AH
HAIDAR	HH EY D AH R
HAIDEE	HH EY D IY
HAIDEN	HH EY D AH N
HAIDER	HH EY D ER
HAILEY	HH EY L IY
HAIQA	HH EY K AH
HAITHAM	HH EY TH AH M
HAJAR	HH EY JH AH R
HAJERA	HH AE JH AH R AH
HAJIRA	HH AE JH AH R AH
HAJRA	HH AE JH R AH
HAJRAH	HH AE JH R AH
HAKAN	HH EY K AH N
HAKAN(2)	HH AA K AH N
HAKEEM	HH AA K IY M
HAKIM	HH AA K IY M
HAKIM(2)	AA K IY M
HAL	HH AE L
HALEEMA	HH EY L IY M AH
HALEEMAH	HH EY L IY M AH
HALEIGH	HH EY L EY
HALEMA	HH AE L AH M AH
HALEY	HH EY L IY
HALIL	HH AE L AH L
HALIMA	HH AH L IY M AH
HALIMAH	HH AE L AH M AH
HALLAM	HH AE L AH M
HALLE	HH AE L
HALLE(2)	HH AE L IY
HAMAAD	HH AE M AH D
HAMAD	HH AE M AH D
HAMAS	HH AA M AA S
HAMDA	HH AE M D AH
HAMED	HH AE M D
HAMEED	HH EY M IY D
HAMID	HH AH M IY D
HAMIDA	HH AE M AH D AH
HAMISH	HH AE M IH SH
HAMMAAD	HH AE M AH D
HAMMAD	HH AE M AE D
HAMSA	HH AE M Z AH
HAMSE	HH AE M Z
HAMZA	HH AE M Z AH
HAMZAH	HH AE M Z AH
HANA	HH AE N AH
HANAA	HH AE N AH
HANAD	HH AE N AH D
HANAN	HH EY N AH N
HANEEN	HH EY N IY AH N
HANI	HH AE N IY
HANIF	HH AE N AH F
HANIFA	HH AE N AH F AH
HANIFAH	HH AE N AH F AH
HANNA	HH AE N AH
HANNAH	HH AE N AH
HANNAH-LOUISE	HH AE N AH L UW IY Z
HANNAH-MAY	HH AE N AH M EY
HANNAH-ROSE	HH AE N AH R OW Z
HANNAN	HH AE N AH N
HANS	HH AA N S
HANS(2)	HH AE N Z
HANYA	HH AE N AY AH
HARAN	HH AE R AH N
HARDEEP	HH AA R D IY P
HARDEV	HH AA R D AH V
HARI	HH AA R IY
HARINDER	HH AH R AY N D AH R
HARIS	HH AA R IY S
HARIS(2)	HH EH R IH S
HARISH	HH EH R IH SH
HARJINDER	HH AA R JH AY N D AH R
HARJOT	HH AA R JH AH T
HARKARAN	HH AA R K AH R AE N
HARKIRAN	HH AA R K AH R AH N
HARLEEN	HH AA R L IY AH N
HARLEIGH	HH AA R L EY
HARLEY	HH AA R L IY
HARLIE	HH AA R L AY
HARMAN	HH AA R M AH N
HARMEET	HH AA R M IY T
HARMINDER	HH AA R M AY N D AH R
HARMONY	HH AA R M AH N IY
HAROLD	HH EH R AH L D
HAROON	HH AH R UW N
HARPREET	HH AA R P R IY T
HARRI	HH AE R IY
HARRIE	HH AE R AY
HARRIET	HH EH R IY AH T
HARRIETT	HH AE R IY T
HARRIETTE	HH AE R IY EH T
HARRIS	HH EH R IH S
HARRISON	HH EH R IH S AH N
HARRY	HH EH R IY
HARSH	HH AA R SH
HARSHIL	HH AA R SH AH L
HARSIMRAN	HH AA R S IH M R AH N
HARUN	HH AE R AH N
HARVEER	HH AA R V IH R
HARVEY	HH AA R V IY
HARVIE	HH AA R V IY
HARVINDER	HH AA R V AY N D AH R
HARVIR	HH AA R V AH R
HASAN	HH EY Z AH N
HASEEB	HH EY S IY B
HASEENA	HH EY S IY N AH
HASHAM	HH AA Z HH AE M
HASHIM	HH AE SH IH M
HASIB	HH AE S AH B
HASINA	HH AE S AH N AH
HASNA	HH AE Z N AH
HASNAIN	HH AE Z N EY N
HASSAAN	HH AE S EY AH N
HASSAN	HH AH S AA N
HATICE	HH AE T AY S
HATIM	HH AE T AH M
HATTIE	HH AE T IY
HAWA	HH AO AH
HAYDAN	HH EY D AH N
HAYDEN	HH EY D AH N
HAYDER	HH EY D AH R
HAYDN	HH AY D AH N
HAYDON	HH EY D AH N
HAYLEIGH	HH EY L EY
HAYLEY	HH EY L IY
HAYLIE	HH EY L AY
HAZAL	HH EY Z AH L
HAZEL	HH EY Z AH L
HAZERA	HH AE Z AH R AH
HEATH	HH IY TH
HEATHER	HH EH DH ER
HEBA	HH EH B AH
HEBE	HH IY B
HECTOR	HH EH K T ER
HEENA	HH IY N AH
HEIDI	HH AY D IY
HELAINA	HH AH L EY N AH
HELEDD	HH EH L AH D
HELEENA	HH IY L IY N AH
HELEN	HH EH L AH N
HELENA	HH EH L AH N AH
HELENE	HH AH L IY N
HELOISE	HH AH L OY Z
HEMA	HH EH M AH
HENA	HH EH N AH
HENDRIK	HH EH N D R IH K
HENNA	HH EH N AH
HENNAH	HH EH N AH
HENRI	HH EH N R IY
HENRI(2)	AO R IY
HENRI(3)	AA N R IY
HENRIETTA	HH EH N R IY EH T AH
HENRIK	HH EH N R IH K
HENRY	HH EH N R IY
HERBERT	HH ER B ER T
HERBIE	HH ER B IY
HERMAN	HH ER M AH N
HERMIONE	HH AH R M IY OW N
HERSH	HH ER SH
HESTER	HH EH S T ER
HETAL	HH IY T AH L
HETTY	HH EH T IY
HEULWEN	HH Y UW L W AH N
HIBA	HH IH B AH
HIBAH	HH IH B AH
HIFSA	HH IH F S AH
HILARY	HH IH L ER IY
HINA	HH IH N AH
HINNA	HH IH N AH
HIRA	HH IH R AH
HIRAM	HH AY R AH M
HIRAN	HH AY R AH N
HIREN	HH AY ER AH N
HIRRA	HH AH R AH
HISHAAM	HH IH SH AH M
HISHAM	HH IH SH AH M
HITEN	HH IH T AH N
HO	HH OW
HODA	HH OW D AH
HODAN	HH OW D AH N
HOLLI	HH AA L IY
HOLLIE	HH AA L IY
HOLLY	HH AA L IY
HOLLY-ANN	HH AA L IY AE N
HONEY	HH AH N IY
HONOR	AA N ER
HOPE	HH OW P
HORATIO	HH ER EY SH OW
HOWARD	HH AW ER D
HUBERT	HH Y UW B ER T
HUDA	HH UW D AH
HUGH	HH Y UW
HUGH(2)	Y UW
HUGO	HH Y UW G OW
HUGO(2)	Y UW G OW
HUMA	HH Y UW M AH
HUMAIRA	HH Y UW M AE AH R AH
HUMAIRAA	HH Y UW M AE AH R AH
HUMAIRAH	HH Y UW M AE AH R AH
HUMAYRA	HH Y UW M EY R AH
HUMAYRAA	HH Y UW M EY R AH
HUMERA	HH AH M IH R AH
HUMZA	HH AH M Z AH
HUMZAH	HH AH M Z AH
HUNTER	HH AH N T ER
HUSAIN	HH AH S AY N
HUSAM	HH Y UW S AH M
HUSEYIN	HH Y UW S EY AH N
HUSNA	HH AH Z N AH
HUSNAIN	HH AH Z N EY N
HUSSAIN	HH UW S EY N
HUSSAN	HH AH S AH N
HUSSEIN	HH UW S EY N
HUSSNAIN	HH AH S N EY N
HUW	HH AH W
HUY	HH Y UW IY
HUZAIFA	HH Y UW Z EY F AH
HUZAIFAH	HH Y UW Z EY F AH
HYWEL	HH IH W AH L
IAIN	IY EY N
IAN	IY AH N
IANTO	AY AE N T OW
IBRAHEEM	IH B R AH HH IY M
IBRAHIM	IH B R AA HH IY M
IBRAR	IH B R AH R
IDIL	IH D AH L
IDREES	IH D R IY Z
IDRIS	IH D R AH S
IESHA	IY SH AH
IESTYN	IY S T AH N
IEUAN	Y UW AH N
IFAN	AY F AH N
IFEOLUWA	IH F IY AA L AH W AH
IFEOMA	AH F IY AH M AH
IFRA	IH F R AH
IFRAH	IH F R AH
IHSAAN	IH S EY AH N
IHSAN	IH Z AH N
IHTISHAAM	IH T AH SH AH M
IHTISHAM	IH T AH SH AH M
IKE	AY K
IKECHUKWU	IH K AH CH AH K W UW
IKENNA	AH K EH N AH
IKRA	IH K R AH
IKRAA	IH K R AH
IKRAH	IH K R AH
IKRAM	IH K R AH M
ILANA	IH L AA N AH
ILAYDA	AH L EY D AH
ILIAS	IH L Y AH Z
ILONA	IH L OW N AH
ILYAS	IH L AY AH Z
IMAAD	AH M AA D
IMAAN	AH M EY AH N
IMAD	AH M AE D
IMAM	AY M AE M
IMAN	AY M AH N
IMANI	AH M AE N IY
IMMANUEL	IH M AH N UH L
IMMOGEN	IH M OW JH AH N
IMOGEN	IH M AH G AH N
IMRAN	IH M R AE N
IMTIYAZ	IH M T AY AY AH Z
INAAM	AH N AA M
INAYAH	AH N EY AH
INDER	AY N D AH R
INDERPAL	IH N D AH R P AH L
INDIA	IH N D IY AH
INDIANA	IH N D IY AE N AH
INDIANNA	IH N D AY AE N AH
INDIGO	IH N D AH G OW
INDIGO(2)	IH N D IH G OW
INDYA	IH N D AY AH
INES	IH N IH S
INES(2)	IH N EH S
INGRID	IH NG G R IH D
INIGO	AH N IH G OW
INNES	IH N AH S
IOAN	AY OW AH N
IOANNIS	AY OW N AH S
IOLA	AY OW L AH
IOLO	AY AH L OW
IONA	AY OW N AH
IONE	AY OW N IY
IQBAL	IH K B AH L
IQRA	IH K R AH
IQRAA	IH K R AH
IQRAH	IH K R AH
IRAM	IH R AH M
IRENE	AY R IY N
IRFAN	IH R F AE N
IRIS	AY R AH S
IRIS(2)	AY R IH S
IRUM	IH R AH M
ISA	IY S AH
ISAAC	AY Z AH K
ISAAC(2)	AY Z IH K
ISABEL	IH Z AH B EH L
ISABELLA	IH Z AH B EH L AH
ISABELLE	IH Z AH B EH L
ISADORA	AH S AE D AH R AH
ISAIAH	AY Z EY AH
ISAM	IH S AH M
ISHA	IH SH AH
ISHAAQ	IH SH AH K
ISHAN	IH SH AH N
ISHAQ	IH SH AE K
ISHBEL	IH SH B AH L
ISHMAEL	IH SH M IY L
ISHMAEL(2)	IH SH M EY L
ISHMAIL	IH SH M EY L
ISHRAT	IH SH R AH T
ISHTIAQ	IH SH T IY AH K
ISIAH	IH S AY AH
ISIS	AY S AH S
ISLA	IY L AH
ISLAM	IH S L AA M
ISLAM(2)	IH Z L AH M
ISMA	IH Z M AH
ISMAEEL	IH Z M IY AH L
ISMAEL	IH S M EY L
ISMAIL	IH S M EY L
ISMAY	AY Z M EY
ISOBEL	IH S AH B AH L
ISOBELLA	IH S AH B EH L AH
ISOBELLE	IH S AH B AH L
ISRA	IH Z R AH
ISRAEL	IH Z R IY AH L
ISRAEL(2)	IH Z R EY L
ISRAR	IH Z R AH R
ISSAC	IH S AH K
ISSAC(2)	AY Z IH K
IVAN	AY V AH N
IVANA	IH V AA N AH
IVO	AY V IY OW
IVO(2)	AY V OW
IVY	AY V IY
IWAN	IY W AA N
IZAAC	IH Z AH K
IZAAK	IH Z AH K
IZAAZ	IH Z AH Z
IZABELLA	IH Z AH B EH L AH
IZABELLE	IH Z AH B AH L
JABBAR	JH AH B AA R
JABIR	JH AE B AH R
JAC	JH AE K
JACE	JH EY S
JACEY	JH EY S IY
JACINTA	JH AH S IH N T AH
JACK	JH AE K
JACKIE	JH AE K IY
JACKSON	JH AE K S AH N
JACKY	JH AE K IY
JACOB	JH EY K AH B
JACQUE	ZH EY K
JACQUELINE	JH AE K W AH L IH N
JACQUELINE(2)	JH AE K L IH N
JACQUELINE(3)	JH AE K AH L IH N
JACQUES	ZH AA K
JACQUES(2)	JH AE K
JACQUI	JH AE K W IY
JAD	JH AE D
JADA	JH AE D AH
JADE	JH EY D
JADE-LOUISE	JH EY D L UW IY Z
JADE-MARIE	JH EY D M ER IY
JADEN	JH EY D AH N
JADENE	JH AH D IY N
JADESOLA	JH AH D EH S AH L AH
JADIE	JH EY D IY
JADINE	JH AH D AY N
JADON	JH AE D AH N
JAE	JH EY
JAGDEEP	JH AE G D IY P
JAGJEEVAN	JH AE G IY V AH N
JAGJIT	JH AE G AH T
JAGO	Y AA G OW
JAGRAJ	JH AE G R AH JH
JAGROOP	JH AE G R UW P
JAHANGIR	JH AH HH AE N JH AH R
JAHANZEB	JH AH HH AE N Z AH B
JAHID	JH AE HH AH D
JAHMAL	JH AE M AH L
JAHMEL	JH AE M AH L
JAI	JH AY
JAI(2)	HH AY
JAIDE	JH EY D
JAIDEEP	JH EY D IY P
JAIDEN	JH EY D AH N
JAIME	HH AY M IY
JAIME-LEE	HH AY M IY L IY
JAIME-LEIGH	HH AY M IY L IY
JAIMEE	JH EY M IY IY
JAIMIE	JH EY M IY
JAIMIE(2)	HH AY M IY
JAIMIN	JH EY M AH N
JAIMINI	JH EY M AH N IY
JAINA	JH EY N AH
JAK	JH AE K
JAKE	JH EY K
JAKIA	JH EY K IY AH
JAKIR	JH AE K AH R
JAKOB	JH AE K AH B
JAKUB	JH AE K AH B
JALAL	JH EY L AH L
JAMAAL	JH AE M EY AH L
JAMAHL	JH AE M AH L
JAMAINE	JH AH M EY N
JAMAL	JH AH M AA L
JAMAR	Y AA M AA R
JAMEEL	JH AE M IY L
JAMEELAH	JH EY M IY L AH
JAMEL	JH AE M AH L
JAMES	JH EY M Z
JAMESON	JH EY M S AH N
JAMEY	JH EY M IY
JAMIE	JH EY M IY
JAMIE-LEE	JH EY M IY L IY
JAMIE-LEIGH	JH EY M IY L IY
JAMIELEE	JH AE M IY L IY
JAMIL	JH AE M AH L
JAMILA	JH AH M IH L AH
JAMILLA	JH AH M IH L AH
JAN	JH AE N
JANA	JH AE N AH
JANAID	JH AH N EY D
JANAY	JH AE N EY IY
JANE	JH EY N
JANELLE	ZH AH N EH L
JANET	JH AE N AH T
JANET(2)	JH AE N IH T
JANICE	JH AE N AH S
JANICE(2)	JH AE N IH S
JANIE	JH EY N IY
JANINE	JH AH N IY N
JANKI	JH AE NG K IY
JANNA	JH AE N AH
JANNAH	JH AE N AH
JANNAT	JH AE N AH T
JARAD	JH AE R AH D
JARED	JH EH R IH D
JARETH	JH AA R IH TH
JARON	JH AA R AO N
JARRAD	JH AE R AH D
JARRED	JH AA R D
JARREN	JH AA R AH N
JARRET	JH AE R AH T
JARRETT	JH EH R AH T
JARROD	JH AE R AH
JARRYD	JH AE R IH D
JARVIS	JH AA R V AH S
JARVIS(2)	JH AA R V IH S
JASDEEP	JH AE Z D IY P
JASKARAN	JH AE S AH R AH N
JASKIRAN	JH AE S AH R AH N
JASLEEN	JH EY Z L IY AH N
JASMEET	JH AE Z M IY T
JASMIN	JH AE Z M IH N
JASMINA	Y AH S M AY N AH
JASMINDER	JH AE Z M AY N D AH R
JASMINE	JH AE Z M AH N
JASMINE(2)	JH AE Z M IH N
JASMYN	JH AE Z M AH N
JASNEET	JH AE Z N IY T
JASON	JH EY S AH N
JASPAL	JH AE S P AA L
JASPER	JH AE S P ER
JASPREET	JH AE S R IY T
JASRAJ	JH AE Z R AH JH
JASWINDER	JH AE S W AY N D AH R
JATINDER	JH AH T AY N D AH R
JAVAIRIA	JH AE V AH AH R IY AH
JAVAN	JH AH V AA N
JAVED	JH EY V D
JAVERIA	JH AH V IY R IY AH
JAVIER	HH AA V IY EH R
JAWAAD	JH AO AH D
JAWAD	JH AH W AA D
JAWWAD	JH AO W AA D
JAXON	JH AE K S AH N
JAY	JH EY
JAY-JAY	JH EY JH EY
JAYA	JH AY AH
JAYAN	JH EY AH N
JAYCE	JH EY S
JAYCEE	JH EY S IY
JAYCIE	JH EY S AY
JAYDA	JH EY D AH
JAYDE	JH EY D
JAYDEN	JH EY D EH N
JAYDENE	JH EY D IY N
JAYDN	JH EY D N
JAYDON	JH EY D AA N
JAYE	JH EY
JAYED	JH EY D
JAYESH	JH EY AH SH
JAYKE	JH EY K
JAYME	JH EY M IY
JAYMEE	JH EY M IY IY
JAYMIE	JH EY M AY
JAYMIE-LEIGH	JH EY M AY L IY
JAYNA	JH EY N AH
JAYNE	JH EY N
JAYSON	JH EY Z AH N
JAZ	JH AE Z
JAZMIN	JH AE Z M IH N
JAZMINE	JH AE Z M AY N
JAZMYN	JH AE Z M AH N
JAZZ	JH AE Z
JAZZMIN	JH AE Z M AH N
JEAN	JH IY N
JEAN-JACQUES	JH IY N ZH AA K
JEAN-LUC	JH IY N L UW K
JEAN-PAUL	JH IY N P AO L
JEANETTE	JH AH N EH T
JEANNIE	JH IY N IY
JED	JH EH D
JEDD	JH EH D
JEDIAH	JH IY D AY AH
JEDIDIAH	JH AH D IH D AY AH
JEEVAN	JH IY V AH N
JEFF	JH EH F
JEFFERSON	JH EH F ER S AH N
JEFFERY	JH EH F ER IY
JEFFREY	JH EH F R IY
JELANI	JH EH L AH N IY
JEM	JH EH M
JEMAINE	JH AH M EY N
JEMAL	JH IY M AH L
JEMILA	JH EH M AH L AH
JEMIMA	JH EH M IY M AH
JEMIMAH	JH EH M AH M AH
JEMMA	JH EH M AH
JENA	JH IY N AH
JENESSA	JH AH N EH S AH
JENIKA	JH EH N AH K AH
JENNA	JH EH N AH
JENNI	JH EH N IY
JENNIE	JH EH N IY
JENNIFER	JH EH N AH F ER
JENNY	JH EH N IY
JENS	JH EH N Z
JENSEN	JH EH N S AH N
JENSON	JH EH N S AH N
JEORGIA	JH IY AO R JH IY AH
JEREMIAH	JH EH R AH M AY AH
JEREMY	JH EH R AH M IY
JERMAIN	JH AH R M EY N
JERMAINE	JH ER M EY N
JEROME	JH ER OW M
JERRY	JH EH R IY
JESAMINE	JH EH S AH M AY N
JESS	JH EH S
JESSAMINE	JH EH S AH M IH N
JESSAMY	JH EH S AH M IY
JESSE	JH EH S IY
JESSI	JH EH S IY
JESSICA	JH EH S IH K AH
JESSICCA	JH EH S IH K AH
JESSIE	JH EH S IY
JESSIKA	JH EH S AH K AH
JESSY	JH EH S IY
JETHRO	JH EH TH R OW
JEVAN	JH IY V AH N
JEVON	JH EH V AH N
JEYDA	JH EY D AH
JEZ	JH EH Z
JIA	JH IY AH
JIBRAN	JH IH B R AH N
JIBRIL	JH IH B R AH L
JILL	JH IH L
JILLIAN	JH IH L IY AH N
JILLIAN(2)	JH IH L Y AH N
JILLY	JH IH L IY
JIM	JH IH M
JIMI	JH IH M IY
JIMMIE	JH IH M IY
JIMMY	JH IH M IY
JITEN	JH AY T AH N
JIVAN	JH AY V AH N
JO	JH OW
JOAB	JH OW B
JOACHIM	Y OW AA K IH M
JOACHIM(2)	W AA K IY M
JOAN	JH OW N
JOANNA	JH OW AE N AH
JOANNE	JH OW AE N
JOAO	JH OW OW
JOBE	JH OW B
JOBIE	JH AA B IY
JOBY	JH AA B IY
JOCELYN	JH AO S L IH N
JODI	JH OW D IY
JODIE	JH OW D IY
JODIE-LEE	JH OW D IY L IY
JODIE-LEIGH	JH OW D IY L IY
JODY	JH OW D IY
JOE	JH OW
JOEL	JH OW AH L
JOELLE	JH OW EH L
JOELY	JH OW AH L IY
JOESPH	JH OW AH S
JOEY	JH OW IY
JOHAN	Y OW HH AA N
JOHANN	Y OW HH AA N
JOHANNA	JH AH HH AE N AH
JOHANNES	JH OW HH AE N AH S
JOHN	JH AA N
JOHN-LUKE	JH AA N L UW K
JOHN-PAUL	JH AA N P AO L
JOHNATHAN	JH AA N AH TH AH N
JOHNATHON	JH AA N AH TH AH N
JOHNNIE	JH AA N IY
JOHNNY	JH AA N IY
JOHNSON	JH AA N S AH N
JOLENE	JH OW L IY N
JOLIE	JH OW L IY
JOLON	JH AA L AH N
JOLYON	JH AA L AY AH N
JON	JH AA N
JON-LUC	JH AA N L UW K
JON-PAUL	JH AA N P AO L
JONAH	JH OW N AH
JONAS	JH OW N AH S
JONATHAN	JH AA N AH TH AH N
JONATHON	JH AA N AH TH AH N
JONI	JH OW N IY
JONJO	JH AA N JH OW
JONNY	JH AA N IY
JONOTHAN	JH AA N AH TH AH N
JONTY	JH AA N T IY
JOOLS	JH UW L Z
JORDAN	JH AO R D AH N
JORDAN-LEE	JH AO R D AH N L IY
JORDANA	Y AO R D AE N AH
JORDANE	JH AO R D EY N
JORDANN	JH AO R D AH N
JORDANNA	JH AO R D AE N AH
JORDANNE	JH AO R D AH N
JORDEN	JH AO R D AH N
JORDI	JH AO R D IY
JORDON	JH AO R D AH N
JORDY	JH AO R D IY
JORDYN	JH AO R D AH N
JORGE	HH AO R HH EY
JORGIE	JH AO R JH AY
JORJA	JH AO R JH AH
JORY	JH AO R IY
JOSE	HH OW Z EY
JOSEF	JH OW S AH F
JOSEFF	JH AA S AH F
JOSEPH	JH OW S AH F
JOSEPH(2)	JH OW Z AH F
JOSEPHINE	JH OW S AH F IY N
JOSH	JH AA SH
JOSHAN	JH AA SH AH N
JOSHUA	JH AA SH UW AH
JOSHUA-JAMES	JH AA SH UW AH JH EY M Z
JOSHUAH	JH AH SH UW W AH
JOSIAH	JH OW S AY AH
JOSIE	JH OW Z IY
JOSS	JH AO S
JOTHAM	JH AA T HH AE M
JOURDAN	ZH UH R D AE N
JOVAN	JH OW V AH N
JOVI	JH OW V IY
JOY	JH OY
JOYCE	JH OY S
JOZEF	JH OW Z AH F
JUAN	W AA N
JUAN(2)	HH W AA N
JUANITA	W AA N IY T AH
JUANITA(2)	JH UW AH N IY T AH
JUDAH	JH UW D AH
JUDD	JH AH D
JUDE	JH UW D
JUDITH	JH UW D AH TH
JUDITH(2)	JH UW D IH TH
JUDY	JH UW D IY
JULES	JH UW L Z
JULIA	JH UW L Y AH
JULIAN	JH UW L IY AH N
JULIAN(2)	JH UW L Y AH N
JULIANA	JH UW L IY AE N AH
JULIANNE	JH UW L IY EH N
JULIE	JH UW L IY
JULIEN	JH UW L IY AH N
JULIET	JH UW L IY EH T
JULIETTE	JH UW L IY EH T
JULIUS	JH UW L Y AH S
JUN	JH AH N
JUNAID	JH UW N EY D
JUNED	JH UW N D
JUNIOR	JH UW N Y ER
JUSTICE	JH AH S T AH S
JUSTICE(2)	JH AH S T IH S
JUSTIN	JH AH S T AH N
JUSTIN(2)	JH AH S T IH N
JUSTINA	Y UW S T IY N AH
JUSTINE	JH AH S T IY N
JUSTUS	JH AH S T AH S
JYOTI	JH AY AH T IY
KA	K AA
KAAN	K EY AH N
KAASHIF	K AA SH AH F
KABIR	K AE B AH R
KACEY	K EY S IY
KACIE	K EY S AY
KADE	K EY D
KADEEM	K EY D IY M
KADIE	K EY D AY
KADIR	K AE D AH R
KADY	K EY D IY
KAELAN	K IY L AH N
KAELEM	K IY L AH M
KAI	K AY
KAIA	K EY AH
KAILAN	K EY AH L AH N
KAILEM	K EY L AH M
KAILEN	K EY AH L AH N
KAILUM	K EY L AH M
KAIN	K EY N
KAINAAT	K EY N AH T
KAINAT	K EY N AH T
KAINE	K EY N
KAIRO	K AE AH R OW
KAIS	K EY AH S
KAISHA	K EY SH AH
KAITLAN	K EY T L AH N
KAITLIN	K EY T L AH N
KAITLYN	K EY T L AH N
KAIYA	K EY AY AH
KAJ	K AE JH
KAJAL	K EY JH AH L
KAJOL	K AE JH AH L
KALA	K AE L AH
KALAN	K EY L AH N
KALEB	K AE L AH B
KALEEM	K EY L IY M
KALEIGH	K EY L EY
KALEM	K AE L AH M
KALEN	K EY L AH N
KALEY	K EY L IY
KALI	K AE L IY
KALIB	K AE L AH B
KALILA	K AE L AH L AH
KALIM	K AE L AH M
KALISHA	K AE L AH SH AH
KALLAM	K AE L AH M
KALLAN	K AE L AH N
KALLIE	K AE L AY
KALLUM	K AE L AH M
KALON	K AE L AH N
KALUM	K AE L AH M
KALVIN	K AE L V AH N
KAMAAL	K AE M EY AH L
KAMAL	K EY M AH L
KAMAR	K EY M AH R
KAMARA	K AE M AH R AH
KAMEN	K AA M EH N
KAMEN(2)	K EY M EH N
KAMERON	K AE M AH R AH N
KAMIL	K AE M AH L
KAMILAH	K AE M AH L AH
KAMRAAN	K AE M R EY AH N
KAMRAN	K AE M R AH N
KAMRON	K AE M R AH N
KAMRUL	K AE M R AH L
KANE	K EY N
KANISHA	K AE N AH SH AH
KAPIL	K AE P AH L
KARA	K EH R AH
KARAM	K AE R AH M
KARAN	K EH R AH N
KARANDEEP	K AE R AH N D IY P
KARANVEER	K AE R AH N V IH R
KAREEM	K ER IY M
KAREL	K EH R AH L
KAREN	K EH R AH N
KARENA	K AE R AH N AH
KARIM	K ER IY M
KARIN	K EH R IH N
KARINA	K AE R AH N AH
KARIS	K EH R IY Z
KARISHMA	K AH R IH SH M AH
KARISMA	K AH R IH Z M AH
KARL	K AA R L
KARLA	K AA R L AH
KARLEY	K AA R L IY
KARLIE	K AA R L AY
KARLY	K AA R L IY
KARN	K AA R N
KARRIE	K AE R AY
KARUN	K ER UW N
KARYN	K AE R IH N
KASAM	K AE S AH M
KASEY	K AE S IY
KASH	K AE SH
KASHIF	K AE SH AH F
KASIA	K EY ZH IY AH
KASIM	K AE S AH M
KASSIE	K AE S AY
KASSIM	K AE S AH M
KATARINA	K AA T ER IY N AH
KATE	K EY T
KATELYN	K AE T AH L AH N
KATERINA	K AH T EH R AH N AH
KATEY	K EY T IY
KATHARINE	K AE TH R IH N
KATHERINE	K AE TH ER IH N
KATHERINE(2)	K AE TH R IH N
KATHERYN	K AE TH AH R AH N
KATHLEEN	K AE TH L IY N
KATHRINE	K AE TH R AY N
KATHRYN	K AE TH R IH N
KATHY	K AE TH IY
KATIA	K AA T IY AH
KATIE	K EY T IY
KATIE-ANN	K EY T IY AE N
KATIE-JANE	K EY T IY JH EY N
KATIE-LOUISE	K EY T IY L UW IY Z
KATIE-MARIE	K EY T IY M ER IY
KATJA	K AA T Y AH
KATRIN	K AE T R AH N
KATRINA	K AH T R IY N AH
KATRIONA	K AE T R IY AH N AH
KATY	K EY T IY
KATYA	K AA T Y AH
KAUSAR	K EY AH S AH R
KAVAN	K EY V AH N
KAVI	K AE V IY
KAVITA	K AE V AH T AH
KAY	K EY
KAYA	K AA Y AH
KAYDEN	K EY D AH N
KAYLA	K EY L AH
KAYLAN	K EY L AH N
KAYLEE	K EY L IY IY
KAYLEIGH	K EY L EY
KAYLEIGH-ANNE	K EY L EY AE N
KAYLEM	K EY L AH M
KAYLEN	K EY L AH N
KAYLEY	K EY L IY
KAYLIE	K EY L IY
KAYLIEGH	K EY L AY
KAYLUM	K EY L AH M
KAYLUN	K EY L AH N
KAYNE	K EY N
KAYSHA	K EY SH AH
KAZI	K AE Z IY
KAZIA	K EY Z IY AH
KAZIM	K AE Z AH M
KAZUKI	K AH Z UW K IY
KEAGAN	K IY G AH N
KEAH	K IY
KEALAN	K IY L AH N
KEALEY	K IY L IY
KEANA	K IY N AH
KEANE	K IY N
KEANNA	K IY N AH
KEANO	K IY N OW
KEANU	K IY AA N UW
KEANU(2)	K EY AA N UW
KEARA	K IY R AH
KEARON	K IY R AH N
KEATON	K IY T AH N
KEEGAN	K IY G AH N
KEELAN	K IY L AH N
KEELEIGH	K IY L EY
KEELEY	K IY L IY
KEELIE	K IY L IY
KEELY	K IY L IY
KEENAN	K IY N AH N
KEESHA	K IY SH AH
KEGAN	K IY G AH N
KEHINDE	K EH HH AH N D
KEIFER	K IY F ER
KEIGHLEY	K EY L IY
KEILAN	K IY AH L AH N
KEIR	K IY R
KEIRA	K IY R AH
KEIRAN	K IY R AH N
KEIREN	K IY R AH N
KEIRON	K IY R AH N
KEISHA	K IY SH AH
KEITH	K IY TH
KELAN	K IY L AH N
KELCIE	K EH L S AY
KELEIGH	K IY L EY
KELLAN	K EH L AH N
KELLEN	K EH L AH N
KELLEY	K EH L IY
KELLEY(2)	OW K EH L IY
KELLI	K EH L IY
KELLIE	K EH L IY
KELLY	K EH L IY
KELLY-ANN	K EH L IY AE N
KELLY-ANNE	K EH L IY AE N
KELLY-MARIE	K EH L IY M ER IY
KELSEA	K EH L S IY AH
KELSEY	K EH L S IY
KELSI	K EH L S IY
KELSIE	K EH L S AY
KELVIN	K EH L V AH N
KELVIN(2)	K EH L V IH N
KEMAL	K AH M AA L
KEN	K EH N
KENAN	K IY N AH N
KENDAL	K EH N D AH L
KENDALL	K EH N D AH L
KENDELL	K EH N D AH L
KENDRA	K EH N D R AH
KENNA	K EH N AH
KENNADY	K EH N EY D IY
KENNEDY	K EH N AH D IY
KENNETH	K EH N IH TH
KENNY	K EH N IY
KENT	K EH N T
KENTON	K EH N T AH N
KENYA	K EH N Y AH
KENYA(2)	K IY N Y AH
KENZIE	K EH N Z IY
KEON	K IY AH N
KEREM	K EH R AH M
KEREN	K IY R AH N
KERENSA	K AH R EH N S AH
KERENZA	K AH R EH N Z AH
KERI	K EH R IY
KERIM	K EH R AH M
KERN	K ER N
KERRI	K EH R IY
KERRIE	K EH R AY
KERRIN	K EH R AH N
KERRIS	K EH R IY Z
KERRY	K EH R IY
KERRY-ANN	K EH R IY AE N
KERRY-ANNE	K EH R IY AE N
KERRYN	K EH R AH N
KERSTIN	K AH R S T AH N
KERYS	K EH R AH Z
KESHAV	K EH SH AH V
KESHIA	K EH SH IY AH
KESTER	K EH S T ER
KETAN	K IY T AH N
KEVAL	K IY V AH L
KEVAN	K EH V AH N
KEVIN	K EH V IH N
KEYLEIGH	K EY L EY
KEZIA	K IY Z IY AH
KEZIAH	K AH Z IY AH
KHADEEJA	K HH EY D IY JH AH
KHADEEJAH	K HH EY D IY JH AH
KHADEJA	K HH AE D AH JH AH
KHADIJA	K HH AE D AH JH AH
KHADIJAH	K HH AE D AH JH AH
KHADIZA	K HH AE D AH Z AH
KHAI	K HH EY
KHALED	HH AH L AH D
KHALED(2)	K AH L AH D
KHALEEL	K HH EY L IY L
KHALID	K AA L IH D
KHALID(2)	HH AA L IH D
KHALIL	K AE L AH L
KHAN	K AA N
KHARI	K HH AE R IY
KHIZAR	K HH AY Z AH R
KHIZER	K HH AY Z AH R
KHLOE	K HH L OW
KHURAM	K HH Y UH R AH M
KHURUM	K HH Y UH R AH M
KHUSHAL	K HH AH SH AH L
KI	K IY
KIA	K IY ER
KIAH	K AY AH
KIAL	K AY AH L
KIALL	K AY AH L
KIAN	K AY AH N
KIANA	K AY AH N AH
KIANNA	K AY AE N AH
KIARA	K AY AH R AH
KIARAN	K AY AH R AH N
KIAYA	K AY AE AY AH
KIE	K AY
KIEFER	K IY F ER
KIER	K IH R
KIERA	K IY R AH
KIERAN	K IY R AH N
KIEREN	K IY R AH N
KIERIAN	K IY R IY AH N
KIERON	K IY R AH N
KIERRA	K IY R AH
KIERRAN	K IY R AH N
KILE	K AY L
KILIAN	K IH L IY AH N
KILLIAN	K IH L Y AH N
KIM	K IH M
KIMBERLEY	K IH M B ER L IY
KIMBERLY	K IH M B ER L IY
KIN	K IH N
KINGSLEY	K IH NG Z L IY
KINZA	K IH N Z AH
KIRA	K IH R AH
KIRAN	K AY R AH N
KIRANDEEP	K IH R AH N D IY P
KIRANJIT	K AH R AE N JH AH T
KIRANPREET	K IH R AH N P R IY T
KIRBIE	K AH R B AY
KIRBY	K ER B IY
KIREN	K AY R AH N
KIRI	K IH R IY
KIRK	K ER K
KIRON	K IH R AH N
KIRSTEN	K ER S T AH N
KIRSTI	K AH R S T IY
KIRSTIE	K ER S T IY
KIRSTIN	K ER S T IH N
KIRSTY	K AH R S T IY
KIRSTYN	K AH R S T AH N
KISHAN	K IH SH AH N
KISHEN	K IH SH AH N
KIT	K IH T
KITTY	K IH T IY
KIYA	K AY AY AH
KIZZY	K IH Z IY
KLARA	K L AE R AH
KLAY	K L EY
KLEIN	K L AY N
KLINE	K L AY N
KLOE	K L OW
KOBI	K OW B IY
KODIE	K OW D AY
KODY	K OW D IY
KOFI	K OW F IY
KOJO	K OW JH OW
KOMAL	K OW M AH L
KONNA	K AA N AH
KONNER	K AA N ER
KONNOR	K AA N AH R
KONRAD	K AA N R AH D
KORAY	K AO R EY IY
KOREN	K AO R AH N
KOREY	K AO R IY
KORI	K AO R IY
KORY	K AO R IY
KOURTNEY	K AH R T N IY
KRIS	K R IH S
KRISHAN	K R IH SH AH N
KRISHNA	K R IH SH N AH
KRISHNA(2)	K R IY SH N AH
KRISTA	K R IH S T AH
KRISTAL	K R IH S T AH L
KRISTEN	K R IH S T AH N
KRISTI	K R IH S T IY
KRISTIAN	K R IH S AH N
KRISTIANA	K R IH S T IY AH N AH
KRISTIE	K R IH S T IY
KRISTIN	K R IH S T IH N
KRISTINA	K R IH S T IY N AH
KRISTINE	K R IH S T IY N
KRISTOFER	K R IH S T OW F AH R
KRISTOFFER	K R IH S T AA F AH R
KRISTOPHER	K R IH S T AH F ER
KRISTY	K R IH S T IY
KRUPA	K R UW P AH
KRYSTAL	K R IH S T AH L
KRYSTINA	K R IH S T AH N AH
KRYSTYNA	K R IH S T AH N AH
KUBRA	K AH B R AH
KULSOOM	K AH L S UW M
KULSUM	K AH L S AH M
KULSUMA	K AH L S UW M AH
KUNAL	K Y UW N AH L
KURAN	K Y UH R AH N
KURRAN	K AH R AH N
KURT	K ER T
KURTIS	K ER T IH S
KUSH	K UH SH
KUSHAL	K AH SH AH L
KWABENA	K W AA B AH N AH
KWAKU	K W AE K UW
KWAME	K W EY M
KWOK	K W AA K
KYA	K AY AH
KYAH	K AY AH
KYAL	K AY AH L
KYAN	K AY AH N
KYE	K AY
KYLA	K IH L AH
KYLAN	K AY L AH N
KYLE	K AY L
KYLER	K AY L ER
KYLIE	K IH L AY
KYM	K IH M
KYMBERLEY	K IH M B AH R L IY
KYNA	K IH N AH
KYNAN	K AY N AH N
KYRA	K AY R AH
KYRAN	K AY R AH N
KYRIACOS	K AH R IY AH K AH Z
KYRON	K AY R AH N
LABIB	L AE B AH B
LACE	L EY S
LACEY	L EY S IY
LACHLAN	L AE K L AH N
LACIE	L EY S IY
LAILA	L EY L AH
LAINA	L EY N AH
LAINE	L EY N
LAITH	L EY TH
LAKEISHA	L EY K IY SH AH
LAKSHMI	L AE K M IY
LAMAR	L AH M AA R
LAMIN	L AE M IH N
LANA	L AE N AH
LANCE	L AE N S
LANE	L EY N
LARA	L AA R AH
LARAIB	L AH R EY B
LARISA	L AE R AH S AH
LARISSA	L AA R IY S AH
LARRY	L EH R IY
LARS	L AA R Z
LATASHA	L AH T AA SH AH
LATIF	L AE T AH F
LATIFAH	L AE T AH F AH
LATISHA	L AH T IH SH AH
LAURA	L AO R AH
LAURA-BETH	L AO R AH B EH TH
LAURA-JANE	L AO R AH JH EY N
LAURA-JAYNE	L AO R AH JH EY N
LAURAN	L EY Y AH R AH N
LAUREL	L AO R AH L
LAUREN	L AO R AH N
LAURENCE	L AO R AH N S
LAURENS	L AO R AH N Z
LAURENT	L AO R AH N T
LAURIE	L AO R IY
LAURIE(2)	L AA R IY
LAURISSA	L AH R IH S AH
LAURYN	L AO R AH N
LAVINIA	L AH V IH N Y AH
LAWRENCE	L AO R AH N S
LAWRIE	L AO R IY
LAWSON	L AO S AH N
LAYLA	L EY L AH
LAYNE	L EY N
LAYTON	L EY T AH N
LEA	L IY
LEAH	L IY AH
LEAM	L IY M
LEANA	L IY N AH
LEANN	L IY AE N
LEANNA	L IY N AH
LEANNE	L IY N
LEE	L IY
LEEANN	L IY AH N
LEEANNE	L IY AH N
LEENA	L IY N AH
LEIA	L IY AH
LEIF	L IY F
LEIGH	L IY
LEIGH-ANN	L IY AE N
LEIGH-ANNE	L IY AE N
LEIGHA	L EY AH
LEIGHANN	L EY AH N
LEIGHANNE	L EY AH N
LEIGHTON	L EY T AH N
LEILA	L IY L AH
LEILAH	L IY L AH
LEISHA	L IY SH AH
LEMAR	L IH M AA R
LENA	L IY N AH
LENNIE	L EH N IY
LENNON	L EH N AH N
LENNOX	L EH N AH K S
LENNY	L EH N IY
LEO	L IY OW
LEON	L IY AA N
LEONA	L IY OW N AH
LEONARD	L EH N ER D
LEONARDO	L IY AH N AA R D OW
LEONI	L EH OW N IY
LEONI(2)	L IY OW N IY
LEONIE	L EH N IY
LEONNIE	L IY AA N AY
LEONORA	L IY AH N AO R AH
LEROY	L IY R OY
LESLEY	L EH S L IY
LESLIE	L EH S L IY
LESTER	L EH S T ER
LETICIA	L AH T IH SH AH
LETISHA	L EH T AH SH AH
LETITIA	L IH T IH SH IY AH
LEVENT	L IY V AH N T
LEVI	L IY V AY
LEWES	L UW Z
LEWIS	L UW IH S
LEWYS	L UW AH Z
LEYLA	L EY L AH
LEYTON	L EY T AH N
LIA	L IY AH
LIAH	L AY AH
LIAM	L IY AH M
LIAN	L Y AA N
LIANA	L IY AA N AH
LIANE	L IY AE N
LIANNA	L IY AA N AH
LIANNE	L IY AE N
LIBAN	L AY B AH N
LIBBIE	L IH B AY
LIBBY	L IH B IY
LIBERTY	L IH B ER T IY
LIDIA	L IH D IY AH
LIIBAN	L IY B AH N
LILA	L IY L AH
LILI	L IH L IY
LILIA	L IY L IY AH
LILIAN	L IH L IY AH N
LILIAN(2)	L IH L Y AH N
LILIANA	L IH L IY AE N AH
LILITH	L IH L IH TH
LILLI	L IH L IY
LILLIAN	L IH L IY AH N
LILLIE	L IH L IY
LILLY	L IH L IY
LILY	L IH L IY
LILY-ANN	L IH L IY AE N
LILY-ANNE	L IH L IY AE N
LILY-MAY	L IH L IY M EY
LINA	L IY N AH
LINCOLN	L IH NG K AH N
LINDA	L IH N D AH
LINDEN	L IH N D AH N
LINDON	L IH N D AH N
LINDSAY	L IH N D Z IY
LINDSEY	L IH N D Z IY
LINFORD	L IH N F ER D
LINSEY	L IH N Z IY
LINUS	L AY N AH S
LINZI	L IH N Z IY
LIONEL	L AY AH N AH L
LISA	L IY S AH
LISA-MARIE	L IY S AH M ER IY
LISHA	L IH SH AH
LIVIA	L IH V IY AH
LIYAH	L AY AY AH
LIZA	L IY Z AH
LIZZIE	L IH Z IY
LLEWELLYN	L UW EH L IH N
LLEWELYN	L UW IH L IH N
LLIAM	L AY AH M
LLINOS	L IH N AH Z
LLION	L AY AH N
LLOYD	L OY D
LLYR	L IH R
LLYWELYN	L IH W AH L AH N
LOGAN	L OW G AH N
LOIC	L OW AH K
LOIS	L OW AH S
LOLA	L OW L AH
LORA	L AO R AH
LORAN	L AO R AE N
LORCAN	L AO R K AH N
LORD	L AO R D
LOREN	L AO R AH N
LORENZO	L ER EH N Z OW
LORENZO(2)	L AO EH N Z OW
LORETTA	L ER EH T AH
LORI	L AO R IY
LORIEN	L OW R IY AH N
LORNA	L AO R N AH
LORRAINE	L ER EY N
LORREN	L AO R AH N
LOTTE	L AA T
LOTTIE	L AA T IY
LOUI	L AW IY
LOUIE	L UW IY
LOUIS	L UW IH S
LOUIS(2)	L UW IY
LOUISA	L UW IY Z AH
LOUISE	L UW IY Z
LOWELL	L OW AH L
LOWENA	L OW AH N AH
LOWRI	L OW R IY
LUBNA	L AH B N AH
LUC	L UW K
LUCA	L UW K AH
LUCAS	L UW K AH S
LUCI	L UW S IY
LUCIA	L UW SH AH
LUCIAN	L UW SH AH N
LUCIANO	L UW CH IY AA N OW
LUCIE	L UW S IY
LUCIEN	L UW S IY AH N
LUCILLE	L UW S IY L
LUCINDA	L UW S IH N D AH
LUCUS	L UW K AH S
LUCY	L UW S IY
LUCY-ANN	L UW S IY AE N
LUCY-ANNE	L UW S IY AE N
LUI	L UW IH
LUIGI	L UW IY JH IY
LUIS	L UW IY S
LUISA	L UW IY Z AH
LUKA	L UW K AH
LUKAS	L UW K AH Z
LUKE	L UW K
LUQMAAN	L AH K M EY AH N
LUQMAN	L AH K M AH N
LUTHER	L UW TH ER
LYALL	L AY AH L
LYDIA	L IH D IY AH
LYLE	L AY L
LYNDON	L IH N D AH N
LYNDSAY	L IH N D S EY IY
LYNDSEY	L IH N D Z IY
LYNETTE	L AY N EH T
LYNETTE(2)	L IH N EH T
LYNSEY	L IH N Z IY
LYNTON	L IH N T AH N
MAARIA	M AA R IY AH
MAARIYA	M AH R IY AY AH
MAARIYAH	M AH R IY AY AH
MABEL	M EY B AH L
MAC	M AE K
MACAULAY	M AH K AO L IY
MACAULEE	M AE K EY AH L IY IY
MACAULEY	M AH K AO L IY
MACAULLEY	M AH K AO L IY
MACAULLY	M AE K EY UH L IY
MACAULY	M AE K AH L IY
MACKENZIE	M AH K EH N Z IY
MACORLEY	M AH K AO R L IY
MACSEN	M AE K S AH N
MADALAINE	M AE D AH L EY N
MADDIE	M AE D IY
MADDISON	M AE D IH S AH N
MADEEHA	M EY D IY HH AH
MADELAINE	M AE D IH L EY N
MADELEINE	M AE D AH L EH N
MADELINE	M AE D AH L IH N
MADELYN	M AE D IH L IH N
MADELYN(2)	M AE D L IH N
MADIHA	M AE D AH HH AH
MADISON	M AE D AH S AH N
MADISON(2)	M AE D IH S AH N
MAE	M EY
MAEGAN	M IY G AH N
MAEVE	M AH EH V
MAGDALENA	M AE G D AH L IY N AH
MAGGIE	M AE G IY
MAGNUS	M AE G N AH S
MAHA	M AE HH AH
MAHAD	M AE HH AH D
MAHAMED	M AH HH EY M D
MAHAMMED	M AE HH AH M D
MAHBUB	M AE B AH B
MAHDI	M AA D IY
MAHER	M AA R
MAHFUZ	M AE F AH Z
MAHIR	M AE HH AH R
MAHMOOD	M AE M UW D
MAHMOOD(2)	M AA M UW D
MAHMOUD	M AE M UW D
MAHMOUD(2)	M AA M UW D
MAHMUDA	M AE M Y UW D AH
MAHNOOR	M AE N OW AH R
MAHOMED	M AH HH OW M D
MAHUM	M AE HH AH M
MAI	M AY
MAIA	M AY AH
MAIR	M EH R
MAIRA	M AE AH R AH
MAIREAD	M OY R AH
MAIRI	M AE AH R IY
MAISHA	M EY SH AH
MAISIE	M EY Z IY
MAISON	M EY Z AH N
MAISY	M EY Z IY
MAIZIE	M EY Z AY
MAJA	M AE JH AH
MAJED	M EY JH D
MAJID	M AH JH IH D
MAKEDA	M AE K AH D AH
MAKENZIE	M AH K EH N Z AY
MAKHAN	M AE K AH N
MALACHI	M AH L AE CH IY
MALACHY	M AE L EY K IY
MALAK	M AE L AH K
MALCOLM	M AE L K AH M
MALEEHA	M AH L IY HH AH
MALEK	M AA L EH K
MALIHA	M AH L IH HH AH
MALIK	M AE L IH K
MALIKA	M AH L IH K AH
MALIQUE	M AH L IH K
MALKA	M AE L K AA
MAN	M AE N
MANAV	M AE N AH V
MANDEEP	M AE N D IY P
MANDY	M AE N D IY
MANINDER	M AH N AY N D AH R
MANISH	M AE N IH SH
MANISHA	M AE N AH SH AH
MANJINDER	M AE N JH AY N D AH R
MANNAN	M AE N AH N
MANOJ	M AE N AH JH
MANON	M AA N AO N
MANPREET	M AE N P R IY T
MANRAJ	M AE N R AH JH
MANSOOR	M AE N S OW AH R
MANU	M AA N UW
MANUEL	M AA N W EH L
MANVEER	M AE N V IH ER
MANVINDER	M AE N V AY N D AH R
MANVIR	M AE N V AH R
MARA	M AA R AH
MARC	M AA R K
MARCEL	M AA R S EH L
MARCELL	M AA R S EY L
MARCELLA	M AA R S EH L AH
MARCELLO	M AA R S EH L OW
MARCIA	M AA R SH AH
MARCIN	M AA R S IY N
MARCO	M AA R K OW
MARCOS	M AA R K OW S
MARCUS	M AA R K AH S
MARED	M EH R D
MAREK	M AA R EH K
MARGARET	M AA R G ER IH T
MARGARET(2)	M AA R G R AH T
MARGARET(3)	M AA R G R IH T
MARGOT	M AA R G OW
MARI	M AA R IY
MARIA	M ER IY AH
MARIAH	M ER AY AH
MARIAM	M EH R IY AE M
MARIAMA	M AH R IY AH M AH
MARIAN	M EH R IY AH N
MARIANA	M EH R IY AE N AH
MARIANNA	M AA R IY AA N AH
MARIANNE	M EH R IY AE N
MARIE	M ER IY
MARIELLA	M AH R IY L AH
MARIKA	M AE R AH K AH
MARINA	M ER IY N AH
MARIO	M AA R IY OW
MARION	M EH R IY AH N
MARIOS	M AE R IY AH Z
MARISA	M AH R IH S AH
MARISSA	M AH R IH S AH
MARIUM	M AE R IY AH M
MARIUS	M EH R IY AH S
MARIYA	M AH R IY AY AH
MARIYAH	M AH R IY AY AH
MARIYAM	M AH R IY AY AH M
MARJANA	M AA R JH AH N AH
MARK	M AA R K
MARKO	M AA R K OW
MARKUS	M AA R K AH S
MARLA	M AA R L AH
MARLEY	M AA R L IY
MARLON	M AA R L AH N
MARNI	M AA R N IY
MARNIE	M AA R N AY
MARRIYAH	M AE R IY AY AH
MARSHA	M AA R SH AH
MARSHALL	M AA R SH AH L
MARTA	M AA R T AH
MARTELL	M AA R T EH L
MARTHA	M AA R TH AH
MARTI	M AA R T IY
MARTIN	M AA R T AH N
MARTIN(2)	M AA R T IH N
MARTINA	M AA R T IY N AH
MARTINE	M AA R T IY N
MARTY	M AA R T IY
MARTYN	M AA R T IH N
MARUF	M AE R AH F
MARVIN	M AA R V IH N
MARWA	M AA R W AH
MARWAN	M AA R W AA N
MARY	M EH R IY
MARY-ANN	M EH R IY AE N
MARY-ANNE	M EH R IY AE N
MARY-JANE	M EH R IY JH EY N
MARYA	M AA R Y AH
MARYAM	M AE R AY AH M
MARYAN	M AE R AY AH N
MARYANN	M EH R IY AE N
MARYANNE	M EH R IY AE N
MARYUM	M AE R AY AH M
MASON	M EY S AH N
MASSIMO	M AE S IH M OW
MASUD	M AE S AH D
MASUMA	M AH S UW M AH
MATHEW	M AE TH Y UW
MATHIAS	M AH TH AY AH S
MATHIAS(2)	M AH T IY AH S
MATHILDA	M AH T IH L D AH
MATHILDE	M AE TH IH L D
MATHILDE(2)	M AH T IH L D
MATIAS	M AA SH AH Z
MATILDA	M AH T IH L D AH
MATT	M AE T
MATTEO	M AA T EY OW
MATTHEW	M AE TH Y UW
MATTHIAS	M AH TH AY AH S
MATTHIEU	M AE T TH Y UW
MAUREEN	M AO R IY N
MAURICE	M AO R IY S
MAURICE(2)	M AA R IH S
MAVERICK	M AE V ER IH K
MAVERICK(2)	M AE V R IH K
MAX	M AE K S
MAXIM	M AE K S AH M
MAXIME	M AE K S IY M
MAXIMILIAN	M AE K S IH M IH L IY AH N
MAXIMILIEN	M AE K S IY M AY L IY AH N
MAXIMILLIAN	M AE K S AH M IH L IY AH N
MAXINE	M AE K S IY N
MAXWELL	M AE K S W EH L
MAY	M EY
MAYA	M AY AH
MAYANK	M EY AH NG K
MAYSON	M EY Z AH N
MAYUR	M EY AH R
MCAULEY	M AH K AO L IY
MCCAULEY	M AH K AO L IY
MCCAULLEY	M AH K AO L IY
MCCAWLEY	M AH K AO L IY
MCKENZIE	M AH K EH N Z IY
MD	EH M D
MD.	EH M D IY
MEAGAN	M IY AH JH AH N
MEAGHAN	M IY AH N
MEENA	M IY N AH
MEERA	M IH R AH
MEG	M EH G
MEGAN	M EY G AH N
MEGGAN	M EH G AH N
MEGHAN	M EH G AH N
MEGHANN	M EH AH N
MEHDI	M EH D IY
MEHMET	M EH M AH T
MEHRAN	M EH R AH N
MEHREEN	M EH R IY AH N
MEHUL	M EH HH UH L
MEHVISH	M EH V AH SH
MEHWISH	M EH W AH SH
MELANIE	M EH L AH N IY
MELINA	M EH L IY N AH
MELINDA	M AH L IH N D AH
MELIS	M IY L AH S
MELISA	M EH L AH S AH
MELISSA	M AH L IH S AH
MELIZ	M EH L AH Z
MELLISA	M EH L AH S AH
MELLISSA	M EH L IH S AH
MELODY	M EH L AH D IY
MELVIN	M EH L V IH N
MENACHEM	M AH N AA HH AH M
MENACHEM(2)	M EH N AH HH EH M
MENNA	M EH N AH
MERCEDES	M ER S EY D IY Z
MERCY	M ER S IY
MEREDITH	M EH R IH D IH TH
MERLIN	M ER L IH N
MERRICK	M EH R IH K
MERRYN	M EH R AH N
MERT	M AH R T
MERVE	M AH R V
MERYEM	M EH R AY AH M
MERYL	M EH R AH L
MESHACH	M EH SH AH CH
METIN	M EH T IH N
MHAIRI	M HH AE AH R IY
MIA	M IY AH
MIAH	M AY AH
MICA	M AY K AH
MICAELA	M IY K EY L AH
MICAH	M AY K AH
MICHA	M IH CH AH
MICHAEL	M AY K AH L
MICHAELA	M AY K EH L AH
MICHAELLA	M AY K EH L AH
MICHAL	M IH CH AH L
MICHEAL	M AY K AH L
MICHEALA	M AH CH IY L AH
MICHELA	M IH K EY L AH
MICHELE	M IH SH EH L
MICHELLE	M IH SH EH L
MICKEY	M IH K IY
MICKY	M IH K IY
MIGUEL	M IH G EH L
MIHIR	M IH HH AH R
MIKAEL	M AH K EY L
MIKAELA	M IY K EY L AH
MIKAIL	M AH K EY L
MIKAYLA	M AH K EY L AH
MIKE	M AY K
MIKESH	M IH K IH SH
MIKEY	M AY K IY
MIKHAIL	M IH K EY L
MIKHAIL(2)	M IH K AY L
MILAD	M IH L AH D
MILAN	M AH L AA N
MILAN(2)	M IH L AA N
MILAN(3)	M AY L AE N
MILES	M AY L Z
MILES(2)	M AY AH L Z
MILLICENT	M IH L IH S IH N T
MILLIE	M IH L IY
MILLY	M IH L IY
MILO	M AY L OW
MIMI	M IY M IY
MINA	M IY N AH
MINA(2)	M IH N AH
MINESH	M IH N AH SH
MINHAJ	M IH N HH AH JH
MIR	M IH R
MIRA	M IH R AH
MIRAJ	M IH R AH JH
MIRANDA	M ER AE N D AH
MIRIAM	M IH R IY AH M
MIRREN	M IH R AH N
MIRZA	M ER Z AH
MISBA	M IH S B AA
MISBAH	M IH S B AE
MISCHA	M IH SH AH
MISHA	M IH SH AH
MISTY	M IH S T IY
MITCH	M IH CH
MITCHEL	M IH CH AH L
MITCHELL	M IH CH AH L
MITEN	M AY T AH N
MITESH	M IH T AH SH
MITUL	M IH T AH L
MIZAN	M AY Z AH N
MOBEEN	M OW B IY AH N
MOESHA	M OW AH SH AH
MOHAMAD	M AH HH AA M AH D
MOHAMED	M OW HH AA M EH D
MOHAMMAD	M OW HH AA M EH D
MOHAMMED	M OW HH AE M IH D
MOHAMMMED	M AA HH AH M D
MOHAMMOD	M AH HH AE M AH D
MOHAMOD	M AA HH AH M AH D
MOHD	M AA D
MOHEEN	M AA HH IY AH N
MOHIB	M AA HH AH B
MOHIMA	M AA HH AH M AH
MOHINI	M AA HH AH N IY
MOHIT	M OW HH IY T
MOHIT(2)	M OW HH IH T
MOHMED	M AA M D
MOHMMED	M AA M D
MOHSAN	M AA Z AH N
MOHSIN	M AA S AH N
MOIN	M OY N
MOISHE	M OW SH EH
MOISHE(2)	M OY SH IH
MOIZ	M OY Z
MOLLI	M AA L IY
MOLLIE	M AA L IY
MOLLY	M AA L IY
MOLLY-ANN	M AA L IY AE N
MOMINA	M AA M AH N AH
MONA	M OW N AH
MONEEB	M OW N IY B
MONET	M OW N EY
MONICA	M AA N IH K AH
MONIKA	M AA N AH K AH
MONIQUE	M OW N IY K
MONIRA	M AA N AH R AH
MONISHA	M AA N AH SH AH
MONTAGUE	M AA N T AH G Y UW
MONTANA	M AA N T AE N AH
MONTEL	M AA N T EH L
MONTELL	M AA N T AH L
MONTGOMERY	M AA N T G AH M R IY
MONTY	M AO N T IY
MOONISAH	M UW N AH S AH
MORDECHAI	M AO R D AH K AY
MORENIKE	M AO R AH N AY K
MORGAN	M AO R G AH N
MORRIS	M AO R AH S
MORRIS(2)	M AO R IH S
MORTIMER	M AO R T IH M ER
MORVEN	M AO R V AH N
MORWENNA	M AO R W EH N AH
MOSES	M OW Z AH S
MOSES(2)	M OW Z IH S
MOSHE	M OW SH EH
MOSHE(2)	M OW SH AH
MOSTAFA	M AA S T AH F AH
MUBARAK	M UW B AA R IH K
MUBARAK(2)	M Y UW B AA R IH K
MUBEEN	M Y UW B IY AH N
MUDASSAR	M AH D AE S ER
MUHAMAD	M AH HH AH M AH D
MUHAMMAD	M UH HH AA M AH D
MUHAMMED	M UH HH AA M EH D
MUHAMMOD	M AH HH AE M AH D
MUHIBUR	M AH HH AH B AH R
MUHSIN	M AH S AH N
MUJAHID	M Y UW JH AH HH AH D
MUJTABA	M AH JH T AH B AH
MUKESH	M Y UW K AH SH
MUKHTAR	M AH K T AH R
MUMINAH	M Y UW M AH N AH
MUNA	M Y UW N AH
MUNEEB	M Y UW N IY B
MUNEEBA	M Y UW N IY B AH
MUNEEBAH	M Y UW N IY B AH
MUNIR	M Y UW N AH R
MURAD	M Y UH R AE D
MURAT	M Y UH R AH T
MURRAY	M ER IY
MURRAY(2)	M AH R IY
MURSHED	M AH R SH T
MURTAZA	M AH R T AH Z AH
MUSA	M Y UW S AH
MUSAMMAT	M Y UW S AE M AH T
MUSTAF	M AH S T AH F
MUSTAFA	M UW S T AA F AH
MUSTAPHA	M AH S T AH F AH
MUZZAMMIL	M AH Z AE M AH L
MYA	M AY AH
MYAH	M AY AH
MYFANWY	M AH F AE N W IY
MYLES	M AY L Z
MYLO	M IH L OW
MYRA	M AY R AH
MYRON	M AY R AH N
NABEEL	N AE B IY L
NABEELA	N EY B IY L AH
NABEELAH	N EY B IY L AH
NABIEL	N EY B IY L
NABIHA	N AE B AH HH AH
NABIL	N AA B IY
NABILA	N AE B AH L AH
NABILAH	N AE B AH L AH
NADA	N AA D AH
NADEEM	N EY D IY M
NADIA	N AE D Y AH
NADIA(2)	N AA D Y AH
NADIM	N AE D AH M
NADINE	N AH D IY N
NADIR	N EY D ER
NADIYA	N EY D IY AY AH
NADJA	N AE D Y AH
NADYA	N AE D AY AH
NAEEM	N IY AH M
NAEEMA	N IY AH M AH
NAFEES	N EY F IY Z
NAFEESA	N EY F IY S AH
NAFISA	N AE F AH S AH
NAFISAH	N AE F AH S AH
NAGINA	N AE JH AH N AH
NAHEEM	N AH HH IY M
NAHID	N AE HH AH D
NAHIDA	N AE HH AH D AH
NAHIM	N AE HH AH M
NAHUM	N AE HH AH M
NAILA	N EY L AH
NAILAH	N EY L AH
NAIM	N AY IH M
NAIMA	N EY M AH
NAIMAH	N EY M AH
NAJMA	N AE JH M AH
NAKISHA	N AE K AH SH AH
NAKITA	N AE K AH T AH
NANA	N AE N AH
NANCY	N AE N S IY
NANDINI	N AE N D AH N IY
NAOMI	N EY OW M IY
NASEEM	N EY S IY M
NASIM	N AE S AH M
NASIMA	N AE S AH M AH
NASIR	N AE S AH R
NASRA	N AE Z R AH
NASREEN	N EY Z R IY AH N
NASSER	N AE S ER
NASSIM	N AE S AH M
NATACHA	N AE T AH CH AH
NATALIA	N AH T AA L Y AH
NATALIE	N AE T AH L IY
NATALYA	N AH T AE L AY AH
NATASHA	N AH T AA SH AH
NATASHA(2)	N AH T AE SH AH
NATASHIA	N AH T AE SH IY AH
NATASJA	N AH T AE Z AH
NATHALIE	N AE T AH L IY
NATHAN	N EY TH AH N
NATHANAEL	N AE TH AH N EY L
NATHANIAL	N AH TH EY N IY AH L
NATHANIEL	N AH TH AE N Y AH L
NATHEN	N AE TH AH N
NAUMAN	N AW M AH N
NAVDEEP	N AE V D IY P
NAVEED	N EY V IY D
NAVEENA	N EY V IY N AH
NAVJOT	N AE V AH T
NAVNEET	N AE V N IY T
NAVPREET	N AE V P R IY T
NAVRAJ	N AE V R AH JH
NAWAL	N AO AH L
NAYAN	N EY AH N
NAYIM	N EY AH M
NAZIA	N EY Z IY AH
NAZIFA	N AE Z AH F AH
NAZIM	N AE Z AH M
NAZIR	N AE Z AH R
NAZISH	N EY Z AH SH
NAZMA	N AE Z M AH
NAZMEEN	N AE Z M IY AH N
NAZMIN	N AE Z M AH N
NAZMUL	N AE Z M AH L
NAZNEEN	N AE Z N IY AH N
NAZREEN	N EY Z R IY AH N
NEAL	N IY L
NEAVE	N IY V
NED	N EH D
NEEL	N IY L
NEELAM	N IY L AH M
NEERAJ	N IH R AH JH
NEESHA	N IY SH AH
NEEVE	N IY V
NEHA	N EH HH AH
NEHEMIAH	N IY AH M AY AH
NEIL	N IY L
NEISHA	N IY SH AH
NELLIE	N EH L IY
NELSON	N EH L S AH N
NENEH	N EH N
NERISSA	N AH R IH S AH
NERYS	N EH R AH Z
NEVAN	N IY V AH N
NIA	N AY AH
NIAL	N AY AH L
NIALL	N AY L
NIAM	N AY AH M
NIAMH	N AY AH M
NICHOLA	N IH HH OW L AH
NICHOLAS	N IH K AH L AH S
NICHOLAS(2)	N IH K L AH S
NICHOLE	N IH K OW L
NICK	N IH K
NICKI	N IH K IY
NICKOLAS	N IH K AH L AH Z
NICKY	N IH K IY
NICO	N IY K OW
NICOL	N IH K AH L
NICOLA	N IH K OW L AH
NICOLAI	N IY K OW L AA IY
NICOLAS	N IH K AH L AH S
NICOLE	N IH K OW L
NICOLETTE	N IH K AH L EH T
NICOLLE	N IH K OW L
NIDA	N IY D AH
NIGEL	N AY JH AH L
NIK	N IH K
NIKESH	N IH K AH SH
NIKHIL	N IH K AH L
NIKHITA	N IH K AH T AH
NIKI	N IH K IY
NIKISHA	N IH K AH SH AH
NIKITA	N IH K IY T AH
NIKITA(2)	N AH K IY T AH
NIKKI	N IH K IY
NIKKITA	N IH K AH T AH
NIKO	N IY K OW
NIKOLA	N IH K OW L AH
NIKOLAI	N IH K OW L AY
NIKOLAOS	N AH K AA L EY AH Z
NIKOLAS	N IH K AH L AH Z
NILE	N AY L
NILES	N AY L Z
NILIMA	N IH L AH M AH
NILS	N IH L Z
NIMA	N IH M AH
NIMRA	N IH M R AH
NIMRAH	N IH M R AH
NINA	N IY N AH
NIOMI	N AY AH M IY
NIRAJ	N IH R AH JH
NISA	N IH S AH
NISHA	N IH SH AH
NISHAN	N IH SH AH N
NISHANT	N IH SH AH N T
NISHAT	N IH SH AH T
NIZAMUDDIN	N IH Z AH M AH D AH N
NO	N OW
NOAH	N OW AH
NOEL	N OW EH L
NOMAN	N OW M AH N
NOOR	N OW AH R
NORA	N AO R AH
NOREEN	N ER IY N
NORMAN	N AO R M AH N
NORTON	N AO R T AH N
NOSHEEN	N AA SH IY AH N
NOSHIN	N AA SH AH N
NUALA	N UW AA L AH
NUHA	N AH HH AH
NUMAAN	N Y UW M EY AH N
NUMAN	N Y UW M AH N
NUR	N UH R
NURUL	N Y UH R AH L
NUSAYBAH	N Y UW S EY B AH
NUSRAT	N AH Z R AH T
NYALL	N AY AH L
NYE	N AY
NYLE	N AY L
NYOMI	N AY AH M IY
NYREE	N AY R IY IY
OAKLEY	OW K L IY
OBINNA	AH B IH N AH
OCEAN	OW SH AH N
OCTAVIA	AA K T EY V IY AH
ODETTE	OW D EH T
ODIN	OW D AH N
OGHENETEGA	AA AH N EH T AH G AH
OISIN	OY S AH N
OKAN	OW K AH N
OLADELE	AA L AH D IY L
OLAMIDE	AA L AH M AY D
OLAOLUWA	AA L EY AA L AH W AH
OLGA	OW L G AH
OLIVE	AA L AH V
OLIVE(2)	AA L IH V
OLIVER	AA L AH V ER
OLIVER(2)	AA L IH V ER
OLIVIA	OW L IH V IY AH
OLIVIER	OW L IH V IY EY
OLLIE	AA L IY
OLLIE(2)	OW L IY
OLUFEMI	AH L UW F AH M IY
OLUMIDE	AA L AH M AY D
OLUSEGUN	AH L UW S AH G AH N
OLUWADAMILARE	AA L AH W AH D AE M AH L AH R
OLUWADAMILOLA	AH L AH W AH D AH M IH L AH L AH
OLUWADEMILADE	AH L AH W AH D EH M AH L EY D
OLUWAFEMI	AA L AH W AA F AH M IY
OLUWAKOREDE	AH L AH W AE K AH R IY D
OLUWAROTIMI	AA L AH W AH R AA T AH M IY
OLUWASEUN	AA L AH W EY S IY AH N
OLUWASEYI	AA L AH W EY S EY IY
OLUWATIMILEYIN	AH L AH W AH T AH M IH L EY AH N
OLUWATOBI	AA L AH W AA T AH B IY
OLUWATOSIN	AA L AH W AA T AH S AH N
OLUWATOYOSI	AA L AH W AH T OY AH S IY
OMAR	OW M AA R
OMARI	AA M AH R IY
OMER	OW M ER
ONKAR	AO NG K AH R
ONUR	AA N AH R
OONAGH	UW N AH
OPAL	OW P AH L
OPEYEMI	OW P EY AH M IY
OPHELIA	AH F IY L Y AH
ORAN	AO R AA N
OREN	AO R AH N
ORIANA	AO R IY AE N AH
ORLA	AO R L AH
ORLAITH	AO R L EY TH
ORLANDO	AO R L AE N D OW
ORRIN	AO R IH N
OSAMA	OW S AA M AH
OSCAR	AO S K ER
OSIAN	OW Z IY AH N
OSKAR	AO S K ER
OSMAN	AA S M AH N
OTIS	OW T IH S
OTTILIE	AA T AH L IY
OTTO	AA T OW
OWAIN	OW EY N
OWAIS	OW EY AH S
OWEN	OW AH N
OYINKANSOLA	OY AH NG K AE N S AH L AH
OZAN	OW Z AH N
OZCAN	AA Z K AH N
OZGE	AA Z
PABLO	P AA B L OW
PADDY	P AE D IY
PADRAIC	P AE D R EY AH K
PADRAIG	P AE D R EY G
PAGAN	P EY G AH N
PAGE	P EY JH
PAIGE	P EY JH
PAIGHTON	P EY T AH N
PAISLEY	P EY Z L IY
PALOMA	P AA L OW M AH
PAMELA	P AE M AH L AH
PANAYIOTIS	P AH N EY IY AH T AH S
PANDORA	P AE N D AO R AH
PAOLO	P AW L OW
PARAM	P AE R AH M
PARDEEP	P AA R D IY P
PARIS	P EH R IH S
PARIS(2)	P AE R IH S
PARISA	P AE R AH S AH
PARISS	P EH R IY Z
PARMINDER	P AA R M AY N D ER
PARRIS	P EH R IH S
PARTH	P AA R TH
PASCAL	P AE S K AE L
PASCALE	P AE S K AE L
PASQUALE	P AA S K W AA L EY
PATIENCE	P EY SH AH N S
PATRICE	P AH T R IY S
PATRICIA	P AH T R IH SH AH
PATRICK	P AE T R IH K
PATRIK	P AE T R AH K
PATSY	P AE T S IY
PAUL	P AO L
PAULA	P AO L AH
PAULINE	P AO L IY N
PAULO	P AO L OW
PAVAN	P EY V AH N
PAVANDEEP	P AE V AH N D IY P
PAVLOS	P AE V L AH Z
PAWANDEEP	P AO AH N D IY P
PAYAL	P EY AH L
PAYTON	P EY T AH N
PEARCE	P IH R S
PEARL	P ER L
PEDRO	P EY D R OW
PEGGY	P EH G IY
PENELOPE	P AH N EH L AH P IY
PENNY	P EH N IY
PEREZ	P EH R EH Z
PERI	P AH R IY
PERRAN	P ER R AE N
PERRI	P ER R IY
PERRIE	P AH R AY
PERRY	P EH R IY
PETAR	P EH T ER
PETE	P IY T
PETER	P IY T ER
PETRA	P EH T R AH
PETROS	P EH T R OW Z
PEYTON	P EY T AH N
PHEBE	F IY B IY
PHEOBE	F IY OW B
PHILIP	F IH L AH P
PHILIP(2)	F IH L IH P
PHILIPPA	F IH L IH P AH
PHILIPPE	F IH L IY P EY
PHILLIP	F IH L IH P
PHILLIPA	F IH L AH P AH
PHILLIPPA	F IH L IH P AH
PHILOMENA	F IH L AH M IY N AH
PHINEAS	F IH N IY AH S
PHOEBE	F IY B IY
PHOENIX	F IY N IH K S
PIA	P IY AH
PIERCE	P IH R S
PIERRE	P IY EH R
PIERS	P IH R Z
PIETRO	P IY EH T R OW
PINAR	P AY N ER
PINCHAS	P IH NG K AH Z
PIPPA	P IH P AH
POLLY	P AA L IY
POLLYANNA	P AA L IY AE N AH
POOJA	P UW JH AH
POONAM	P UW N AH M
POPPIE	P AA P IY
POPPY	P AA P IY
PORSCHA	P AO R S AH
PORTIA	P AO R SH AH
PRABHJOT	P R AE B HH JH AH T
PRANAV	P R AE N AH V
PRANAY	P R AE N EY IY
PRASHANT	P R AA SH AA N T
PRATIK	P R AE T AH K
PRECIOUS	P R EH SH AH S
PREETI	P R IY EH T IY
PREM	P R EH M
PRESTON	P R EH S T AH N
PRIMROSE	P R IH M R OW Z
PRINCE	P R IH N S
PRINCESS	P R IH N S EH S
PRISCILLA	P R IH S IH L AH
PRITESH	P R IH T AH SH
PRITPAL	P R IH T AH L
PRIYA	P R AY AY AH
PRIYANKA	P R AY AY AE NG K AH
PRIYEN	P R AY IY AH N
PRIYESH	P R AY AY AH SH
PTOLEMY	T AA L AH M IY
PUJA	P Y UW JH AH
QAASIM	K AA S AH M
QAIS	K EY AH S
QAISER	K EY AH S AH R
QAMAR	K EY M AH R
QASIM	K AE S AH M
QUADE	K W EY D
QUAZI	K W AA Z IY
QUENTIN	K W EH N T IH N
QUINCY	K W IH N S IY
QUINLAN	K W IH N L AH N
QUINN	K W IH N
QUINTON	K W IH N T AO N
QUOC	K W AA K
RABIA	R EY B IY AH
RABIYA	R EY B IY AY AH
RACHAEL	R EY CH AH L
RACHEAL	R AE CH IY AH L
RACHEL	R EY CH AH L
RACHELLE	R AH SH EH L
RADHA	R AA D AH
RADHIKA	R AE D HH AH K AH
RADWAN	R AE D W AH N
RAE	R EY
RAEES	R IY Z
RAEESA	R IY AH S AH
RAEESAH	R IY AH S AH
RAEGAN	R IY G AH N
RAEKWON	R IY K W AH N
RAFAEL	R AA F AY EH L
RAFE	R EY F
RAFFAELE	R AA F AY EH L EY
RAFI	R AE F IY
RAFI(2)	R AA F IY
RAFIA	R EY F IY AH
RAFIQ	R AE F AH K
RAHAT	R AE HH AH T
RAHATH	R AE HH AH TH
RAHEEL	R AH HH IY L
RAHEEM	R AH HH IY M
RAHEEMA	R AH HH IY M AH
RAHIL	R AE HH AH L
RAHIM	R AH HH IY M
RAHIMA	R AE HH AH M AH
RAHMA	R AE M AH
RAHMAN	R AA M AH N
RAHUL	R AH HH UW L
RAIHAN	R EY AH N
RAIN	R EY N
RAINE	R EY N
RAIS	R EY S
RAIYAN	R EY AY AH N
RAJ	R AA ZH
RAJ(2)	R AA JH
RAJA	R AE JH AH
RAJAN	R EY JH AH N
RAJANDEEP	R AE JH AH N D IY P
RAJEEV	R EY JH IY V
RAJESH	R AE JH AH SH
RAJINDER	R AH JH AY N D AH R
RAJIV	R AA JH IY V
RAJIV(2)	R AA ZH IY V
RAJNI	R AE JH N IY
RAJVEER	R AE JH IH R
RAJVIR	R AE JH AH R
RAKEEM	R EY K IY M
RAKESH	R AE K AH SH
RALPH	R AE L F
RAM	R AE M
RAMAN	R EY M AH N
RAMAN(2)	R AA M AH N
RAMANDEEP	R AE M AH N D IY P
RAMEEZ	R EY M IY Z
RAMEL	R AE M AH L
RAMEZ	R AE M AH Z
RAMI	R AA M IY
RAMLA	R AE M L AH
RAMON	R AH M OW N
RAMONE	R AH M OW N
RAMZAN	R AE M Z AH N
RAMZI	R AE M Z IY
RANA	R AE N AH
RANDALL	R AE N D AH L
RANDEEP	R AE N D IY P
RANIA	R AA N IY AH
RANJIT	R AE N JH AH T
RANVEER	R AE N V IH ER
RANVIR	R AE N V AH R
RAOUL	R AA UW L
RAPHAEL	R AA F AY EH L
RAPHAEL(2)	R AA F Y EH L
RAPHAEL(3)	R EY F IY AH L
RAPHAELLA	R AH F IY L AH
RAQUEL	R AH K EH L
RASHAUN	R AE SH AH N
RASHED	R AE SH T
RASHEL	R AE SH AH L
RASHID	R AH SH IY D
RASHID(2)	R AA SH IY D
RAUL	R AO L
RAUL(2)	R AA UW L
RAUL(3)	R AW L
RAVEENA	R EY V IY N AH
RAVEN	R EY V AH N
RAVI	R AA V IY
RAVINA	R AE V AH N AH
RAVINDER	R AH V AY N D AH R
RAVNEET	R AE V N IY T
RAY	R EY
RAYA	R EY AH
RAYAN	R EY AH N
RAYANNE	R EY AH N
RAYHAAN	R EY HH EY AH N
RAYHAN	R EY AH N
RAYMOND	R EY M AH N D
RAYNA	R EY N AH
RAYON	R EY AH N
RAZA	R AE Z AH
RAZIA	R EY Z IY AH
REA	R EY
REACE	R IY EY S
REAGAN	R EY G AH N
REAGAN(2)	R IY G AH N
REAGEN	R IY G AH N
REAH	R IY AE
REANNA	R IY AE N AH
REANNE	R IY AE N
REBBECCA	R IH B EH K AH
REBECA	R IH B AH K AA
REBECCA	R AH B EH K AH
REBECKA	R IH B AH K AA
REBECKAH	R IH B AH K AE
REBEKA	R IH B IY K AH
REBEKAH	R IH B AH K AE
REBEKKA	R IH B EH K AH
REBEKKAH	R IH B AH K AE
RED	R EH D
REDD	R EH D
REDFORD	R EH D F ER D
REECE	R IY S
REED	R IY D
REEGAN	R IY IY G AH N
REEM	R IY EH M
REEMA	R IY AH M AA
REENA	R IY AH N AA
REES	R IY Z
REESE	R IY S
REEVE	R IY V
REGAN	R IY G AH N
REGGIE	R EH JH IY
REGINA	R IH JH IY N AH
REGINALD	R EH JH AH N AH L D
REHAAN	R AH HH EY AH N
REHAN	R EH AH N
REHMAN	R EH M AH N
REICE	R IY AY S
REID	R IY D
REILLY	R AY L IY
REIS	R IY Z
REISS	R AY S
REMA	R AH M AA
REMEL	R AH M EH L
REMI	R EH M IY
REMIE	R AH M AY
REMMIE	R IH M AY
REMY	R EH M IY
RENAE	R AH N IY
RENE	R AH N EY
RENEE	R AH N EY
RENU	R AH N UW
RENUKA	R IH N Y UW K AH
RESHAM	R IY SH AE M
REUBEN	R UW B AH N
REX	R EH K S
REZWAN	R EH Z W AH N
REZWANA	R IH Z W AA N AH
RHEA	R IY AH
RHEANNA	R IY N AH
RHEANNE	R IY N
RHETT	R EH T
RHIA	R AY AH
RHIAN	R AY AH N
RHIANA	R AY AH N AH
RHIANE	R AY AH N
RHIANN	R AY AH N
RHIANNA	R AY AE N AH
RHIANNAN	R AY AE N AH N
RHIANNE	R AY AH N
RHIANNON	R AY AE N AH N
RHIANON	R AY AH N AH N
RHIDIAN	R IH D IY AH N
RHODA	R OW D AH
RHODRI	R AA D R IY
RHONA	R OW N AH
RHYAN	R AY AH N
RHYANNA	R AY AE N AH
RHYANNE	R AY AH N
RHYANNON	R AY AE N AH N
RHYCE	R AY S
RHYDIAN	R AY D IY AH N
RHYS	R IY S
RHYSE	R AY Z
RIA	R IY AH
RIAH	R AY AH
RIAN	R AY AH N
RIANA	R AY AH N AH
RIANNA	R AY AE N AH
RIANNE	R AY AH N
RIANNON	R AY AE N AH N
RIAZ	R AY AH Z
RICARDO	R IH K AA R D OW
RICCARDO	R IH K AA R D OW
RICCI	R IY CH IY
RICHARD	R IH CH ER D
RICHELLE	R IH CH AH L
RICHIE	R IH CH IY
RICK	R IH K
RICKI	R IH K IY
RICKIE	R IH K IY
RICKY	R IH K IY
RICKY-LEE	R IH K IY L IY
RICO	R IY K OW
RIDA	R IH D AH
RIDHA	R IH D HH AH
RIDHWAN	R IH D W AH N
RIDWAN	R IH D W AA N
RIECE	R IY S
RIFAT	R IH F AH T
RIKESH	R IH K AH SH
RIKIN	R IH K AH N
RIKKI	R IH K IY
RILEY	R AY L IY
RIMA	R IY M AH
RINA	R IY N AH
RIO	R IY OW
RIONA	R AY AH N AH
RIORDAN	R IH R D AH N
RISHABH	R IH SH AH B
RISHI	R IH SH IY
RITA	R IY T AH
RITCHIE	R IH CH IY
RIVER	R IH V ER
RIVKA	R IH V K AH
RIYA	R AY AY AH
RIZWAAN	R IH Z W EY AH N
RIZWAN	R IH Z W AH N
RIZWANA	R IH Z W AH N AH
ROAN	R OW N
ROANNA	R OW N AH
ROB	R AA B
ROBBIE	R AA B IY
ROBBY	R AA B IY
ROBERT	R AA B ER T
ROBERTA	R AH B ER T AH
ROBERTO	R AH B EH R T OW
ROBERTO(2)	R OW B EH R T OW
ROBIN	R AA B AH N
ROBIN(2)	R AA B IH N
ROBSON	R AA B S AH N
ROBYN	R AA B IH N
ROCHEL	R AA CH AH L
ROCHELLE	R OW SH EH L
ROCHELLE(2)	R AH SH EH L
ROCKY	R AA K IY
RODERICK	R AA D R IH K
RODNEY	R AA D N IY
RODRIGO	R AH D R IY G OW
ROGAN	R OW G AH N
ROGER	R AA JH ER
ROHAIL	R AH HH EY L
ROHAN	R OW AH N
ROHEEL	R AH HH IY L
ROHIMA	R AA HH AH M AH
ROHIN	R AA HH AH N
ROHINI	R AA HH AH N IY
ROHIT	R AA HH AH T
ROISIN	R OW IY Z IH N
ROLAND	R OW L AH N D
ROMA	R OW M AH
ROMAN	R OW M AH N
ROMANA	R AA M AH N AH
ROMANY	R AA M AH N IY
ROMANY(2)	R OW M AH N IY
ROMARIO	R AH M AE R IY OW
ROMELLO	R AH M EH L OW
ROMI	R OW M IY
ROMILLY	R OW M IH L IY
ROMMEL	R AA M AH L
ROMY	R OW M IY
RON	R AA N
RONA	R OW N AH
RONAK	R AA N AH K
RONALD	R AA N AH L D
RONAN	R OW N AH N
RONI	R OW N IY
RONNI	R AA N IY
RONNIE	R AA N IY
RONNY	R AA N IY
RORIE	R AO R IY
RORY	R AO R IY
ROSA	R OW Z AH
ROSALIE	R OW Z AH L IY
ROSALIND	R AA Z AH L IH N D
ROSALYN	R AA Z AH L IH N
ROSAMUND	R OW Z AH M UH N D
ROSANNA	R OW Z AE N AH
ROSANNE	R OW Z AE N
ROSE	R OW Z
ROSE-MARIE	R OW Z M ER IY
ROSEANN	R OW S IY N
ROSEANNA	R OW S IY N AH
ROSEANNE	R OW Z AE N
ROSEMARIE	R OW Z M ER IY
ROSEMARY	R OW Z M EH R IY
ROSEY	R OW Z IY
ROSHAN	R AA SH AH N
ROSHANE	R AH SH EY N
ROSHNI	R AA SH N IY
ROSIE	R OW Z IY
ROSIE-MAY	R OW Z IY M EY
ROSINA	R OW Z IY N AH
ROSLYN	R AA Z L IH N
ROSS	R AA S
ROSS(2)	R AO S
ROSY	R OW Z IY
ROWAN	R OW AH N
ROWANNE	R OW AH N
ROWEN	R OW AH N
ROWENA	R OW IY N AH
ROWLAND	R OW L AH N D
ROXANA	R AA K S AE N AH
ROXANNA	R AA K S AE N AH
ROXANNE	R AA K S IH N
ROXANNE(2)	R AA K S AE N
ROXY	R AA K S IY
ROY	R OY
ROYA	R OY AH
ROYCE	R OY S
ROZEENA	R OW Z IY N AH
RUAIRI	R UW W AE AH R IY
RUAIRIDH	R UW W AE AH R AH D
RUARI	R UW W AH R IY
RUARIDH	R UW W AH R AH D
RUBEN	R UW B AH N
RUBIE	R UW B IY
RUBIN	R UW B IH N
RUBINA	R UW B IY N AH
RUBY	R UW B IY
RUDI	R UW D IY
RUDY	R UW D IY
RUEBEN	R UW B IY AH N
RUFUS	R UW F AH S
RUHENA	R AH HH AH N AH
RUKHSAR	R AH K S AH R
RUKSANA	R AH K S AH N AH
RUKSAR	R AH K S AH R
RUKSHANA	R AH K AH N AH
RUMAANAH	R UW M AH N AH
RUMAN	R UW M AH N
RUMANA	R UW M AH N AH
RUMER	R UW M ER
RUPERT	R UW P ER T
RUPINDER	R UW P AY N D AH R
RUQAIYAH	R AH K EY AY AH
RUQAYYAH	R AH K EY AY AH
RUSHIL	R AH SH AH L
RUSSELL	R AH S AH L
RUTH	R UW TH
RYAN	R AY AH N
RYANDEEP	R AY AH N D IY P
RYHAN	R IH AH N
RYKER	R AY K ER
RYLAN	R AY L AH N
RYLAND	R IH L AH N D
RYLEY	R AY L IY
RYO	R AY OW
SAAD	S AA D
SAADIA	S AA D IY AH
SAAGAR	S EY AH JH AH R
SAARA	S AA R AH
SAARAH	S AA R AH
SABA	S AA B AH
SABAAH	S AE B AH
SABAH	S AA B AH
SABAHAT	S AE B AH HH AH T
SABBIR	S AE B AH R
SABEEL	S EY B IY L
SABHA	S AE B HH AH
SABIA	S AA B IY AH
SABIHA	S AE B AH HH AH
SABINA	S AH B IY N AH
SABINE	S AH B IY N
SABIR	S EY B ER
SABIR(2)	S AH B IH R
SABREENA	S AE B R IY N AH
SABRINA	S AH B R IY N AH
SACHA	S AE CH AH
SACHIN	S AE CH AH N
SADAF	S AE D AH F
SADE	S EY D
SADIA	S EY D IY AH
SADIE	S AE D IY
SADIQ	S AE D AH K
SADIYA	S EY D IY AY AH
SADIYAH	S EY D IY AY AH
SAEED	S AA IY D
SAFA	S AE F AH
SAFAA	S AE F AH
SAFEENA	S EY F IY N AH
SAFFRON	S AE F R AH N
SAFIA	S EY F IY AH
SAFINA	S AE F AH N AH
SAFIYA	S EY F IY AY AH
SAFIYAH	S EY F IY AY AH
SAFIYYA	S EY F IY AY AY AH
SAFIYYAH	S EY F IY AY AY AH
SAFWAAN	S AE F W EY AH N
SAFWAN	S AE F W AH N
SAFYAN	S AE F AY AH N
SAGAL	S EY JH AH L
SAGAR	S AA G AA R
SAHAL	S AE AH L
SAHAR	S AE AH R
SAHARA	S AH HH EH R AH
SAHIB	S AE HH AH B
SAHIBA	S AE HH AH B AH
SAHIL	S AE HH AH L
SAHIR	S AE HH AH R
SAHR	S AE R
SAHRA	S AE R AH
SAI	S AY
SAI(2)	EH S EY AY
SAID	S EH D
SAIDA	S EY D AH
SAIF	S AA IY F
SAIF(2)	S AY F
SAIFULLAH	S EY F UH L AH
SAIFUR	S EY F AH R
SAIMA	S EY M AH
SAIQA	S EY K AH
SAIRA	S AE AH R AH
SAIRAH	S AE AH R AH
SAJAD	S AE JH AH D
SAJAN	S EY JH AH N
SAJEDA	S AE JH AH D AH
SAJID	S AE JH AH D
SAJIDA	S AE JH AH D AH
SAKIB	S AE K AH B
SAKINA	S AH K IY N AH
SALEEM	S AE L IY M
SALEHA	S AE L AH HH AH
SALIH	S AE L IY
SALIHA	S AE L AH HH AH
SALIK	S AE L AH K
SALIM	S AE L IH M
SALIM(2)	S AA L IY M
SALIMA	S AE L AH M AH
SALINA	S AH L IY N AH
SALLY	S AE L IY
SALLY-ANN	S AE L IY AE N
SALLY-ANNE	S AE L IY AE N
SALMA	S AE L M AH
SALMAN	S AE M AH N
SALOME	S AH L OW M IY
SALONI	S AE L AH N IY
SALVATORE	S AE L V AH T AO R IY
SALVATORE(2)	S AE L V AH D AO R
SALWA	S AE L W AH
SAM	S AE M
SAMAD	S AE M AH D
SAMAH	S AE M AH
SAMAN	S EY M AH N
SAMANTHA	S AH M AE N TH AH
SAMANTHA-JAYNE	S AH M AE N TH AH JH EY N
SAMAR	S AE M AA R
SAMARA	S AE M ER AH
SAMEER	S AA M IH R
SAMEERA	S EY M IH R AH
SAMERA	S AE M AH R AH
SAMI	S AE M IY
SAMIA	S EY M IY AH
SAMIHA	S AE M AH HH AH
SAMIN	S AE M AH N
SAMINA	S AH M IH N AH
SAMIR	S AH M IH R
SAMIR(2)	S AA M IH R
SAMIRA	S AE M AH R AH
SAMIRAH	S AE M AH R AH
SAMIYA	S EY M IY AY AH
SAMIYAH	S EY M IY AY AH
SAMMI	S AE M IY
SAMMIE	S AE M IY
SAMMY	S AE M IY
SAMMY-JO	S AE M IY JH OW
SAMPSON	S AE M P S AH N
SAMRA	S AE M R AH
SAMRAH	S AE M R AH
SAMRAJ	S AE M R AH JH
SAMSON	S AE M S AH N
SAMUAL	S AE M Y AH W AH
SAMUEL	S AE M Y UW L
SAMUELE	S AE M Y UW AH L
SAMY	S EY M IY
SAMYA	S AE M AY AH
SANA	S AA N AH
SANAA	S AH N AA
SANAH	S AE N AH
SANAM	S AE N AH M
SANCHEZ	S AE N CH EH Z
SANCHIA	S AE NG K IY AH
SANDEEP	S AE N D IY P
SANDRA	S AE N D R AH
SANDY	S AE N D IY
SANHA	S AE N HH AH
SANIA	S EY N Y AH
SANITA	S AE N AH T AH
SANIYA	S EY N IY AY AH
SANJAY	S AE N JH EY
SANJEEV	S AE N JH IY V
SANJIDA	S AE N JH AH D AH
SANJIV	S AA N JH IY V
SANNA	S AE N AH
SANNAH	S AE N AH
SANTIAGO	S AE N T IY AA G OW
SANTINO	S AA N T IY N OW
SANYA	S AE N AY AH
SAOIRSE	S EY OY R S
SAPHIA	S AE F IY AH
SAPHIRE	S AE P HH AY ER
SAPHRON	S AE F R AH N
SAPNA	S AE P N AH
SAPPHIRE	S AE F AY ER
SAQIB	S AE K AH B
SARA	S EH R AH
SARAH	S EH R AH
SARAH-JANE	S EH R AH JH EY N
SARAH-JAYNE	S EH R AH JH EY N
SARAH-LOUISE	S EH R AH L UW IY Z
SARDAR	S AA R D AH R
SAREENA	S AH R IY N AH
SARINA	S AE R AH N AH
SARITA	S AE R AH T AH
SARWAR	S AA R W AH R
SASCHA	S AE S AH
SASHA	S AE SH AH
SASKIA	S AE S IY AH
SATNAM	S AE T N AH M
SAUL	S AO L
SAURAV	S AO R AH V
SAVAN	S EY V AH N
SAVANA	S AE V AH N AH
SAVANAH	S AE V AH N AH
SAVANNA	S AH V AE N AH
SAVANNAH	S AH V AE N AH
SAXON	S AE K S AH N
SAYED	S AA Y EH D
SAYED(2)	S EY Y IH D
SAYED(3)	S EY D
SAYEDA	S EY AH D AH
SAYEED	S EY IY D
SAYEEDA	S EY IY D AH
SCARLET	S K AA R L AH T
SCARLETT	S K AA R L IH T
SCOT	S K AA T
SCOTT	S K AA T
SEAMUS	SH EY M AH S
SEAN	SH AO N
SEANA	S IY N AH
SEANN	S IY N
SEBASTIAN	S AH B AE S CH AH N
SEBASTIEN	S AH B AE S T IY AH N
SEDA	S EY D AH
SEEMA	S IY M AA
SEHAR	S EH AH R
SEHER	S EH HH ER
SEHRISH	S EH R AH SH
SELENA	S AH L IY N AH
SELIN	S EH L IH N
SELINA	S AH L IY N AH
SELINE	S AH L AY N
SEMA	S IY M AH
SEPEHR	S EH P AH R
SERA	S IH R AH
SERAPHINA	S ER AA F IY N AH
SEREN	S IY R AH N
SERENA	S AH R IY N AH
SERENE	S ER IY N
SERGE	S ER JH
SERGEN	S ER JH AH N
SERGIO	S ER JH IY OW
SERHAT	S EH R AH T
SERIN	S EH R AH N
SERINA	S EH R AH N AH
SERISH	S IY R AH SH
SERKAN	S AH R K AH N
SETH	S EH TH
SEYED	S EY D
SHAAN	SH EY AH N
SHABAAZ	SH AE B AH Z
SHABAN	SH EY B AH N
SHABANA	SH AE B AH N AH
SHABAZ	SH AE B AH Z
SHABBIR	SH AE B AH R
SHABNAM	SH AE B N AH M
SHADAB	SH AE D AH B
SHADI	SH AE D IY
SHADIA	SH EY D IY AH
SHAE	SH IY
SHAFIQ	SH AE F AH K
SHAH	SH AA
SHAHANA	SH AE HH AH N AH
SHAHBAAZ	SH AE B AH Z
SHAHBAZ	SH AE B AH Z
SHAHED	SH AA D
SHAHEEN	SH AH HH IY N
SHAHEENA	SH AH HH IY N AH
SHAHID	SH AA AH D
SHAHIDA	SH AE HH AH D AH
SHAHINA	SH AE HH AH N AH
SHAHINUR	SH AE HH AH N AH R
SHAHNAZ	SH AE N AH Z
SHAHRIYAR	SH AA R IY IY ER
SHAHRUKH	SH AE R AH K
SHAHZAIB	SH AH Z EY B
SHAI	SH AY
SHAIKH	SH EY K
SHAILEN	SH EY AH L AH N
SHAIMA	SH EY M AH
SHAINE	SH EY N
SHAISTA	SH EY S T AH
SHAKEAL	SH EY K AH L
SHAKEEL	SH EY K IY L
SHAKIB	SH AE K AH B
SHAKIL	SH AE K AH L
SHAKILA	SH AE K AH L AH
SHAKIR	SH AE K IH R
SHAKIRA	SH AE K IY R AH
SHALINI	SH AE L AH N IY
SHAMAILA	SH AH M EY L AH
SHAMARA	SH AE M AH R AH
SHAMAS	SH AE M AH S
SHAMIL	SH AE M AH L
SHAMILA	SH AE M AH L AH
SHAMIM	SH AE M AH M
SHAMIMA	SH AE M AH M AH
SHAMRAIZ	SH AE M R EY Z
SHAMSA	SH AE M Z AH
SHAMSUL	SH AE M Z AH L
SHAMUS	SH EY M AH S
SHAN	SH AE N
SHANA	SH AE N AH
SHANA(2)	SH EY N AH
SHANADE	SH AH N EY D
SHANAE	SH AE N IY
SHANAZ	SH AE N AH Z
SHANE	SH EY N
SHANEL	SH AE N AH L
SHANELLE	SH AE N AH L
SHANEY	SH EY N IY
SHANI	SH AE N IY
SHANIA	SH EY N Y AH
SHANICE	SH AE N AH S
SHANIE	SH EY N AY
SHANIECE	SH EY N IY S
SHANIKA	SH AE N AH K AH
SHANIL	SH AE N AH L
SHANINE	SH AH N AY N
SHANIQUA	SH AH N IH K W AH
SHANISE	SH AH N AY Z
SHANNA	SH AE N AH
SHANNAGH	SH AE N AH
SHANNAN	SH AE N AH N
SHANNEL	SH AE N AH L
SHANNEN	SH AE N AH N
SHANNICE	SH AE N AH S
SHANNON	SH AE N AH N
SHANNON-LEIGH	SH AE N AH N L IY
SHANNON-LOUISE	SH AE N AH N L UW IY Z
SHANON	SH AE N AH N
SHANTE	SH AE N T
SHANTEL	SH AE N T AH L
SHANTELLE	SH AE N T AH L
SHAQUILLE	SH AH K IY L
SHARA	SH AA R AH
SHAREEN	SH EH R AH N
SHARICE	SH AE R AH S
SHARIF	SH ER IY F
SHARLOTTE	SH AA R L AH T
SHARMAINE	SH AA R M EY N
SHARMIN	SH AA R M AH N
SHARMINA	SH AA R M AH N AH
SHARN	SH AA R N
SHARNA	SH AA R N AH
SHARNE	SH AA R N
SHARNEY	SH AA R N IY
SHARNI	SH AA R N IY
SHARNIE	SH AA R N AY
SHARON	SH AE R AH N
SHARON(2)	SH EH R AH N
SHARON(3)	SH AH R OW N
SHAUN	SH AO N
SHAUNA	SH AO N AH
SHAUNAGH	SH AO N AH
SHAUNI	SH AO N IY
SHAUNIE	SH AO N AY
SHAUNNA	SH AO N AH
SHAW	SH AO
SHAWN	SH AO N
SHAWNA	SH AO N AH
SHAWNEE	SH AO N IY
SHAY	SH EY
SHAYE	SH EY
SHAYLA	SH EY L AH
SHAYNA	SH EY N AH
SHAYNE	SH EY N
SHAZAD	SH AE Z AH D
SHAZAIB	SH AH Z EY B
SHAZIA	SH EY Z IY AH
SHEA	SH EY
SHEENA	SH IY N AH
SHEHZAD	SH EH Z AH D
SHEIK	SH IY K
SHEIKH	SH IY K
SHEILA	SH IY L AH
SHELBI	SH EH L B IY
SHELBIE	SH EH L B AY
SHELBY	SH EH L B IY
SHELDON	SH EH L D AH N
SHELINA	SH EH L AH N AH
SHELLBY	SH EH L B AY
SHELLEY	SH EH L IY
SHELLY	SH EH L IY
SHEM	SH EH M
SHENELLE	SH EH N AH L
SHENICE	SH AH N IY S
SHERAZ	SH EH R AH Z
SHEREE	SH ER IY
SHEREEN	SH IH R IY AH N
SHERELLE	SH EH R AH L
SHERI	SH EH R IY
SHERIDAN	SH EH R IH D AH N
SHERRI	SH EH R IY
SHERRIE	SH EH R IY
SHERRY	SH EH R IY
SHERYL	SH EH R AH L
SHEZAD	SH EH Z AH D
SHIANNE	SH AY AH N
SHILOH	SH AY L OW
SHILPA	SH IH L P AH
SHIMON	SH IY M OW N
SHIMON(2)	SH IY M AH N
SHIRAZ	SH IH R AH Z
SHIREEN	SH AY ER AH N
SHIRLEY	SH ER L IY
SHIV	SH IH V
SHIVAM	SH IH V AH M
SHIVANI	SH IH V AH N IY
SHLOMO	SH L AA M OW
SHMUEL	SH M Y UW AH L
SHOAIB	SH OW AH B
SHOHAIB	SH AH HH EY B
SHOLTO	SH OW L T OW
SHONA	SH OW N AH
SHONAGH	SH AA N AH
SHOSHANA	SH AA SH AH N AH
SHREYA	SH R EY AH
SHRIYA	SH R AY AY AH
SHUAIB	SH UW W EY B
SHUKRI	SH UW K R IY
SHYAM	SH AY AH M
SHYANNE	SH AY AH N
SHYHEIM	SH AH HH IY M
SIAN	S AY AH N
SIANA	S AY AH N AH
SIANI	S AY AH N IY
SIANNA	S AY AE N AH
SIBEL	S IH B AH L
SID	S IH D
SIDDHARTH	S IH D HH AH R TH
SIDHRA	S IH D HH R AH
SIDNEY	S IH D N IY
SIDONIE	S AH D OW N AY
SIDRA	S IH D R AH
SIDRAH	S IH D R AH
SIENA	S IY N AH
SIENNA	S IY EH N AH
SIKANDER	S AH K AE N D AH R
SILAS	S AY L AH S
SILVIA	S IH L V IY AH
SIMA	S IY M AH
SIMEON	S IH M IY AH N
SIMON	S AY M AH N
SIMONE	S IH M OW N
SIMRA	S IH M R AH
SIMRAN	S IH M R AH N
SIMRANDEEP	S IH M R AH N D IY P
SIMRANJEET	S IH M R AH N JH IY T
SIMRANJIT	S IH M R AE N JH AH T
SIMREN	S IH M R AH N
SIMRUN	S IH M R AH N
SINAN	S AY N AH N
SINEAD	S IH N EY AE D
SINEAD(2)	SH IH N IY D
SINEM	S IH N AH M
SIOBHAN	SH AW B AA N
SION	S AY AH N
SIONED	S AY OW N D
SIRAAJ	S IH R AH JH
SIRAJ	S IH R AH JH
SIWAN	S IH W AH N
SKIE	S K AY
SKY	S K AY
SKYE	S K AY
SOBIA	S OW B IY AH
SOFIA	S OW F IY AH
SOFIAN	S OW F IY AH N
SOFIANE	S OW F IY EY N
SOFIE	S AA F IY
SOHAIB	S AH HH EY B
SOHAIL	S AH HH EY L
SOL	S AA L
SOL(2)	S OW L
SOLOMON	S AA L AH M AH N
SOMIA	S OW M IY AH
SOMMER	S AH M ER
SONA	S OW N AH
SONAL	S AH N AH L
SONALI	S AA N AH L IY
SONAM	S AA N AH M
SONIA	S OW N Y AH
SONJA	S OW N Y AH
SONNIE	S AH N IY
SONNY	S AH N IY
SONYA	S OW N Y AH
SOPHIA	S OW F IY AH
SOPHIE	S OW F IY
SOPHIE-ANN	S OW F IY AE N
SOPHIE-LOUISE	S OW F IY L UW IY Z
SOPHIE-MARIE	S OW F IY M ER IY
SOPHY	S OW F IY
SORAYA	S AO R EY AH
SORCHA	S AO R K AH
SORREL	S AO R AH L
SOTIRIS	S AA T AH R AH S
SPENCER	S P EH N S ER
SPIKE	S P AY K
STACEY	S T EY S IY
STACIE	S T AE K IY
STACY	S T EY S IY
STAN	S T AE N
STANLEY	S T AE N L IY
STAR	S T AA R
STAVROS	S T AH V R OW Z
STEFAN	S T EH F AA N
STEFANIE	S T EH F AH N IY
STEFANO	S T EH F AH N OW
STEFANOS	S T EH F AH N AH Z
STEFFAN	S T EH F AH N
STEFFI	S T EH F IY
STELLA	S T EH L AH
STEPHAN	S T EH F AH N
STEPHANE	S T EH F AA N
STEPHANIE	S T EH F AH N IY
STEPHANOS	S T EH F AH N AH Z
STEPHEN	S T IY V AH N
STEPHEN(2)	S T EH F AH N
STEPHENIE	S T EH P HH EH N IY
STEVAN	S T IY V AH N
STEVE	S T IY V
STEVEN	S T IY V AH N
STEVIE	S T IY V IY
STEWART	S T UW ER T
STONE	S T OW N
STORM	S T AO R M
STUART	S T UW ER T
STUART(2)	S T Y UW ER T
STUART(3)	S T AO R T
SUBHAAN	S AH B HH EY AH N
SUBHAN	S AH B AH N
SUFIAN	S UW F IY AH N
SUFIYAN	S UW F IY AY AH N
SUFYAAN	S UW F AY EY AH N
SUFYAN	S UW F AY AH N
SUHAIB	S AH HH EY B
SUHAIL	S AH HH EY L
SUHAYB	S AH HH EY B
SUHAYL	S AH HH EY L
SUKHPREET	S AH K R IY T
SUKHRAJ	S AH K R AH JH
SULAIMAAN	S UW L EY M EY AH N
SULAIMAN	S UW L EY M AH N
SULAYMAN	S UW L EY M AH N
SULEMAN	S UW L AH M AH N
SULEYMAN	S UW L IY M AH N
SULIMAN	S UW L AH M AH N
SULLIVAN	S AH L AH V AH N
SULLIVAN(2)	S AH L IH V AH N
SULMAN	S AH L M AH N
SULTAN	S AH L T AH N
SULTANA	S AH L T AH N AH
SUMAIRA	S UW M AE AH R AH
SUMAIYA	S UW M EY AY AH
SUMAIYAH	S UW M EY AY AH
SUMAN	S UW M AH N
SUMAYA	S UW M EY AH
SUMAYYA	S UW M EY AY AH
SUMAYYAH	S UW M EY AY AH
SUMER	S AH M ER
SUMERA	S AH M IH R AH
SUMMA	S UW M AH
SUMMER	S AH M ER
SUNDEEP	S AH N D IY P
SUNDUS	S AH N D AH S
SUNG	S AH NG
SUNIL	S UW N IH L
SUNITA	S UW N AH T AH
SUNJAY	S AH N JH EY
SUNNY	S AH N IY
SURAJ	S UH R AH JH
SUSAN	S UW Z AH N
SUSANNA	S UW Z AE N AH
SUSANNAH	S UW S AE N AH
SUSIE	S UW Z IY
SUZAN	S UW Z AH N
SUZANNA	S UW Z AE N AH
SUZANNAH	S UW Z AE N AH
SUZANNE	S UW Z AE N
SUZIE	S AH Z IY
SUZY	S UW Z IY
SVEN	S V EH N
SYDNEY	S IH D N IY
SYDNIE	S IH D N AY
SYED	S AY D
SYEDA	S AY AH D AH
SYLVESTER	S IH L V EH S T ER
SYLVIA	S IH L V IY AH
SYLVIE	S IH L V IY
SYMONE	S AH M OW N
TABASSUM	T AH B AE S AH M
TABATHA	T AE B AH TH AH
TABITHA	T AE B IH TH AH
TADGH	T AE JH
TADHG	T AE D HH G
TAFARI	T AE F AH R IY
TAHA	T AE HH AH
TAHERA	T AE HH AH R AH
TAHIR	T AE HH AH R
TAHIRA	T AE HH AH R AH
TAHIRAH	T AE HH AH R AH
TAHLIA	T AE L IY AH
TAHMID	T AE M AH D
TAHMIDUR	T AE M AH D AH R
TAHMINA	T AE M AH N AH
TAHSIN	T AE S AH N
TAI	T AY
TAIBA	T EY B AH
TAIBAH	T EY B AH
TAIT	T EY T
TAIWO	T EY W OW
TAJ	T AA ZH
TAJINDER	T AH JH AY N D AH R
TAL	T AA L
TALA	T AE L AH
TALAL	T AH L AA L
TALHA	T AE L HH AH
TALHAH	T AE L HH AH
TALIA	T EY L Y AH
TALIESIN	T EY L IY S IH N
TALISHA	T AE L AH SH AH
TALITHA	T AE L IH DH AH
TALLON	T AE L AH N
TALLULAH	T AE L UW L AH
TALYA	T AE L AY AH
TAMANNA	T AH M AE N AH
TAMAR	T EY M ER
TAMARA	T AH M AA R AH
TAMEEM	T EY M IY M
TAMER	T EY M ER
TAMERA	T AE M AH R AH
TAMIA	T EY M IY AH
TAMIKA	T AE M AH K AH
TAMINA	T AE M AH N AH
TAMMI	T AE M IY
TAMMIE	T AE M IY
TAMMY	T AE M IY
TAMSIN	T AE M Z AH N
TAMSYN	T AE M Z AH N
TAMZIN	T AE M Z AH N
TAMZYN	T AE M Z AH N
TANAYA	T AE N EY AH
TANIA	T AA N Y AH
TANIKA	T AE N AH K AH
TANIS	T AE N IH S
TANISHA	T AE N AH SH AH
TANITH	T AE N IY TH
TANSY	T AE N Z IY
TANVEER	T AE N V IH ER
TANVIR	T AE N V AH R
TANYA	T AA N Y AH
TANYEL	T AE N AY AH L
TANZEEL	T AE N Z IY L
TANZEELA	T AE N Z IY L AH
TANZILA	T AE N Z AH L AH
TANZIM	T AE N Z AH M
TAOME	T EY OW M
TARA	T EH R AH
TARA(2)	T AA R AH
TARAN	T AE R AH N
TARANDEEP	T AE R AH N D IY P
TAREK	T AE R AH K
TARELL	T AE R AH L
TARIK	T AE R AH K
TARIQ	T AA R IY K
TARIQUE	T AE R AH K
TARKAN	T AA R K AH N
TARON	T AA R AO N
TARRAN	T AA R AE N
TARUN	T AE R AH N
TARYN	T AE R AH N
TASHA	T AE SH AH
TASHAN	T AE SH AH N
TASHANA	T AE SH AH N AH
TASLIMA	T AE Z L AH M AH
TASMIA	T AE Z M IY AH
TASMIN	T AE Z M AH N
TASNEEM	T AE Z N IY M
TASNIA	T AE Z N IY AH
TASNIM	T AE Z N AH M
TASNIMA	T AE Z N AH M AH
TATE	T EY T
TATIANA	T AE T IY AE N AH
TATIANA(2)	T AE T Y AA N AH
TATUM	T EY T AH M
TAUSEEF	T AH S IY F
TAVIS	T AA V IH S
TAVON	T AE V AH N
TAYA	T EY AH
TAYAB	T EY AH B
TAYAH	T EY AH
TAYBA	T EY B AH
TAYBAH	T EY B AH
TAYLA	T EY L AH
TAYLAH	T EY L AH
TAYLAR	T EY L AH R
TAYLER	T EY L ER
TAYLOR	T EY L ER
TAYO	T EY OW
TAYTE	T EY T
TAYYAB	T EY AY AH B
TAYYABA	T EY AY AH B AH
TAYYIB	T EY AY AH B
TAYYIBA	T EY AY AH B AH
TAYYIBAH	T EY AY AH B AH
TAZ	T AE Z
TAZMIN	T AE Z M AH N
TEAGAN	T IY AH JH AH N
TEAH	T IY
TED	T EH D
TEDDY	T EH D IY
TEEGAN	T IY G AH N
TEEJAY	T IY JH EY
TEGAN	T IY G AH N
TEGEN	T IY JH AH N
TEIFION	T IY F IY AH N
TEJ	T EH JH
TEJAL	T IY JH AH L
TEJAY	T EH JH EY IY
TELERI	T EH L AH R IY
TEMITAYO	T AH M IH T EY OW
TEMITOPE	T EH M AH T OW P
TEMPANY	T EH M P AH N IY
TENISHA	T EH N AH SH AH
TERELL	T EH R AH L
TERENCE	T EH R AH N S
TERESA	T ER IY S AH
TERESA(2)	T ER EY S AH
TERI	T EH R IY
TERRANCE	T EH R AH N S
TERREL	T EH R AH L
TERRELL	T EH R AH L
TERRENCE	T EH R AH N S
TERRI	T EH R IY
TERRI-ANN	T EH R IY AE N
TERRIE	T EH R IY
TERRY	T EH R IY
TESNI	T EH Z N IY
TESS	T EH S
TESSA	T EH S AH
TEVIN	T EH V AH N
THADDEUS	TH AE D IY AH S
THAHMINA	TH AE M AH N AH
THAI	T AY
THALIA	TH EY L Y AH
THAMINA	TH AE M AH N AH
THANIA	TH EY N Y AH
THASLIMA	TH AE Z L AH M AH
THEA	TH IY AH
THEADORA	TH IY D AH R AH
THEO	TH IY OW
THEODORA	TH IY AH D AO R AH
THEODORE	TH IY AH D AO R
THEODOROS	TH IY AA D AH R AH Z
THERESA	T ER IY S AH
THERESA(2)	T ER EY S AH
THERESE	TH EH R IY S
THI	TH IY
THIERRY	TH IH R IY
THOM	T AA M
THOMAS	T AA M AH S
THOMAS-LEE	T AA M AH S L IY
THOR	TH AO R
TIA	T IY AH
TIAGO	T AY AH G OW
TIAH	T AY AH
TIAN	T Y AA N
TIANA	T AY AH N AH
TIANNA	T AY AE N AH
TIARNAN	T AY AE R N AH N
TIERNAN	T IH R N AH N
TIERNEY	T IH R N IY
TIFFANI	T IH F AH N IY
TIFFANY	T IH F AH N IY
TILAK	T IH L AH K
TILLIE	T IH L IY
TILLY	T IH L IY
TIM	T IH M
TIMARA	T IH M AH R AH
TIMMY	T IH M IY
TIMON	T AY M AH N
TIMOTHY	T IH M AH TH IY
TINA	T IY N AH
TINASHE	T IH N AH SH
TIRION	T AY ER IY AH N
TOBI	T OW B IY
TOBIAS	T AH B AY AH S
TOBIE	T OW B IY
TOBIN	T OW B IH N
TOBY	T OW B IY
TODD	T AA D
TOLGA	T OW L G AH
TOLULOPE	T AA L AH L OW P
TOM	T AA M
TOMAS	T OW M AA S
TOMASZ	T AA M AH Z
TOMMIE	T AA M IY
TOMMY	T AA M IY
TOMMY-LEE	T AA M IY L IY
TOMMYLEE	T AA M IY L IY
TOMOS	T AA M AA S
TONI	T OW N IY
TONI-LOUISE	T OW N IY L UW IY Z
TONI-MARIE	T OW N IY M ER IY
TONICHA	T AA N AH CH AH
TONIE	T OW N IY
TONISHA	T AA N AH SH AH
TONY	T OW N IY
TONYA	T AA N Y AH
TOR	T AO R
TORAN	T AO R AA N
TORI	T AO R IY
TORIN	T AO R AH N
TOYAH	T OY AH
TRACEY	T R EY S IY
TRACY	T R EY S IY
TRAE	T R IY
TRAFFORD	T R AE F ER D
TRAVIS	T R AE V IH S
TRAYVON	T R EY V AH N
TRAYVOND	T R EY V AH N D
TRE	T R EY
TREMAINE	T R IH M EY N
TREMAYNE	T R EH M EY N
TRENT	T R EH N T
TREVON	T R EH V AH N
TREVOR	T R EH V ER
TREY	T R EY
TRINITY	T R IH N AH T IY
TRINITY(2)	T R IH N IH T IY
TRISHA	T R IH SH AH
TRISHUL	T R IH SH AH L
TRISTAN	T R IH S T AE N
TRISTEN	T R AY Z T EH N
TRISTIAN	T R IH S AH N
TRISTON	T R AY Z T AH N
TRISTRAM	T R IH S T R AH M
TROI	T R OY
TROY	T R OY
TRUDI	T R UW D IY
TRUDIE	T R UW D IY
TRUDY	T R UW D IY
TRUMAN	T R UW M AH N
TRUNG	T R AH NG
TRYSTAN	T R AY Z T AE N
TUDOR	T UW D ER
TUDOR(2)	T Y UW D ER
TUESDAY	T UW Z D IY
TUESDAY(2)	T UW Z D EY
TUESDAY(3)	T Y UW Z D EY
TULLY	T AH L IY
TULSI	T AH L S IY
TY	T AY
TYE	T AY
TYISHA	T AY AH SH AH
TYLA	T IH L AH
TYLER	T AY L ER
TYLER-JAMES	T AY L ER JH EY M Z
TYLOR	T AY L AH R
TYRA	T AY R AH
TYRAN	T AY R AH N
TYREL	T IH R AH L
TYRELL	T AY R AH L
TYRELLE	T IH R AH L
TYRON	T IH R AH N
TYRONE	T AY R OW N
TYRONNE	T IH R AH N
TYRRELL	T AY R EH L
TYSON	T AY S AH N
UBAID	Y UW B EY D
UCHENNA	AH CH EH N AH
UGOCHUKWU	Y UW G AH CH AH K W UW
UGUR	Y UW G AH R
UMA	Y UW M AH
UMAIR	Y UW M AH AH R
UMAR	Y UW M AH R
UMAYR	Y UW M EY R
UMER	Y UW M AH R
UMERA	Y UW M AH R AH
UMME	AH M
UMUT	Y UW M AH T
UNA	UW N AH
UNA(2)	Y UW EH N EY
URIEL	Y AH R IY L
UROOSA	Y AH R UW S AH
URSULA	ER S AH L AH
USAAMAH	Y UW S AH M AH
USAMA	Y UW S AH M AH
USAMAH	Y UW S AH M AH
USMAAN	AH Z M EY AH N
USMAN	AH Z M AH N
UTHMAN	AH TH M AH N
UWAIS	AH W EY AH S
UZAIR	Y UW Z AH AH R
UZMA	AH Z M AH
VAISHALI	V EY SH AH L IY
VALENTINA	V AE L IH N T IY N AH
VALERIE	V AE L ER IY
VAN	V AE N
VANESSA	V AH N EH S AH
VANISHA	V AE N AH SH AH
VARUN	V AE R AH N
VAUGHAN	V AO N
VAUGHN	V AO N
VEER	V IH R
VENETIA	V AH N IY SH IY AH
VERITY	V EH R AH T IY
VERITY(2)	V EH R IH T IY
VERNON	V ER N AH N
VERONICA	V ER AA N IH K AH
VICKI	V IH K IY
VICKIE	V IH K IY
VICKY	V IH K IY
VICTOR	V IH K T ER
VICTORIA	V IH K T AO R IY AH
VIENNA	V IY EH N AH
VIET	V IY EH T
VIGNESH	V IH G N AH SH
VIJAY	V IH JH EY IY
VIKASH	V IH K AH SH
VIKESH	V IH K AH SH
VIKKI	V IH K IY
VIKRAM	V IH K R AH M
VIMAL	V AY M AH L
VINAY	V IH N EY IY
VINCENT	V IH N S AH N T
VINCENT(2)	V IH N S IH N T
VINCENZO	V IH N S EH N Z OW
VINESH	V IH N AH SH
VINNY	V IH N IY
VIOLET	V AY AH L IH T
VIOLET(2)	V AY L IH T
VIRAJ	V IH R AH JH
VIREN	V IH R AH N
VIRGINIA	V ER JH IH N Y AH
VISHAAL	V IH SH EY AH L
VISHAL	V IH SH AH L
VISHNU	V IH SH N UW
VIVEK	V IH V AH K
VIVIAN	V IH V IY AH N
VIVIEN	V IH V IY AH N
VIVIENNE	V IH V IY AH N
VOLKAN	V OW L K AH N
WADE	W EY D
WAHEED	W AH HH IY D
WAHID	W AA HH IY D
WAHIDA	W AA HH AH D AH
WAHIDUL	W AA HH AH D AH L
WAI	W AY
WAJID	W AA JH AH D
WALEED	W AA L IY D
WALID	W AA L IY D
WALLIS	W AO L IH S
WALTER	W AO L T ER
WAQAAR	W AE K EY AH R
WAQAAS	W AE K AH Z
WAQAR	W AE K AH R
WAQAS	W AE K AH Z
WARDA	W AO R D AH
WARIS	W AE R IY Z
WARREN	W AO R AH N
WARRICK	W AO R IH K
WARSAME	W AO R S EY M
WARWICK	W AO R W IH K
WASEEM	W EY S IY M
WASIF	W AA S AH F
WASIM	W AA S AH M
WAYNE	W EY N
WEDNESDAY	W EH N Z D IY
WEDNESDAY(2)	W EH N Z D EY
WENDY	W EH N D IY
WESLEY	W EH S L IY
WESTLEY	W EH S T L IY
WHITNEY	W IH T N IY
WHITNEY(2)	HH W IH T N IY
WILFRED	W IH L F R IH D
WILFRID	W IH L F R IH D
WILIAM	W IH L IY AH M
WILL	W IH L
WILL(2)	W AH L
WILLEM	W IH L AH M
WILLIAM	W IH L Y AH M
WILLIS	W IH L IH S
WILLOW	W IH L OW
WILSON	W IH L S AH N
WING	W IH NG
WINIFRED	W IH N IH F R IH D
WINNIE	W IH N IY
WINSTON	W IH N S T AH N
WYATT	W AY AH T
XANTHE	Z AE N DH
XAVIER	Z EY V Y ER
XENA	Z IY N AH
XENIA	Z IY N IY AH
YAAKOV	Y AA K AH V
YAASEEN	Y AA Z IY AH N
YAGMUR	Y AE G M AH R
YAHYA	Y AH Y AH
YAHYE	Y AE HH AY
YAN	Y AE N
YANNICK	Y AE N IH K
YASAR	Y EY Z AH R
YASEEN	Y EY Z IY AH N
YASEMIN	Y AE S AH M AH N
YASH	Y AE SH
YASIN	Y AE S IH N
YASIR	Y AA S ER
YASIR(2)	Y AA S IH R
YASMEEN	Y AE Z M IY AH N
YASMIN	Y AE Z M IH N
YASMINA	Y AE Z M AH N AH
YASMINE	Y AE Z M IH N
YASSER	Y AE S ER
YASSER(2)	Y AA S ER
YASSIN	Y AE S IH N
YAZMIN	Y AE Z M AH N
YAZMINE	Y AE Z M AY N
YECHEZKEL	Y AH CH EH Z K AH L
YEHUDA	Y AH HH UW D AH
YEHUDAH	Y EH HH Y UW D AH
YES	Y EH S
YIANNIS	Y AY AE N AH S
YISROEL	Y IH Z R OW AH L
YITZCHOK	Y IH T S AH K
YOLANDA	Y OW L AA N D AH
YONATAN	Y OW N EY T AH N
YOSEF	Y OW S AH F
YOUCEF	Y AW S AH F
YOUNES	Y AH N Z
YOUSAF	Y AW S AH F
YOUSEF	Y UW S EH F
YOUSSEF	Y UW S EH F
YOUSUF	Y AW S AH F
YUNUS	Y UW N AH S
YUSEF	Y UW S EH F
YUSRA	Y AH Z R AH
YUSUF	Y UW S AH F
YUSUKE	Y UW S UW K
YUTA	Y UW T AH
YUUKI	Y UW AH K IY
YVES	IY V
YVETTE	IH V EH T
YVONNE	IH V AA N
ZAC	Z AE K
ZACARY	Z EY K AH R IY
ZACCHAEUS	Z AE K IY AH S
ZACH	Z AE K
ZACHARIA	Z AH CH AE R IY AH
ZACHARIAH	Z AE K ER AY AH
ZACHARIAS	Z AE K ER AY AH S
ZACHARIE	Z AE CH AH R AY
ZACHARY	Z AE K ER IY
ZACHERY	Z AE K ER IY
ZACK	Z AE K
ZACKARY	Z AE K AH R IY
ZACKERY	Z AE K ER IY
ZAFAR	Z EY F AH R
ZAHEER	Z AE IH R
ZAHID	Z AE HH AH D
ZAHRA	Z AE R AH
ZAHRAA	Z AE R AH
ZAHRAH	Z AE R AH
ZAID	Z EY D
ZAIN	Z EY N
ZAINA	Z EY N AH
ZAINAB	Z EY N AH B
ZAINEB	Z EY N AH B
ZAINUB	Z EY N AH B
ZAIRA	Z AE AH R AH
ZAK	Z AE K
ZAKARI	Z AE K AH R IY
ZAKARIA	Z AH K AE R IY AH
ZAKARIAH	Z AH K AE R AY AH
ZAKARIYA	Z AE K AH R IY AY AH
ZAKARIYYA	Z AE K AH R IY AY AY AH
ZAKARY	Z EY K AH R IY
ZAKARYA	Z AH K AE R AY AH
ZAKERY	Z EY K AH R IY
ZAKI	Z AA K IY
ZAKIA	Z EY K IY AH
ZAKIR	Z AE K AH R
ZAKK	Z AE K
ZANA	Z AE N AH
ZANE	Z EY N
ZANIB	Z AE N AH B
ZARA	Z AE R AH
ZARAH	Z AE R AH
ZAREEN	Z AE R IY AH N
ZARIN	Z AE R AH N
ZARINA	Z AE R AH N AH
ZAYD	Z EY D
ZAYN	Z EY N
ZAYNA	Z EY N AH
ZAYNAB	Z EY N AH B
ZAYNAH	Z EY N AH
ZAYYAN	Z EY AY AH N
ZEBA	Z EH B AH
ZEBEDEE	Z EH B AH D IY IY
ZECHARIAH	Z AH CH AE R AY AH
ZEENAT	Z IY N AH T
ZEESHAAN	Z IY SH EY AH N
ZEESHAN	Z IY SH AH N
ZEHRA	Z EH R AH
ZEINAB	Z AY N AE B
ZEN	Z EH N
ZENA	Z IY N AH
ZENAB	Z EH N AH B
ZESHAN	Z EH SH AH N
ZETA	Z EY T AH
ZEYAD	Z EY AH D
ZEYNEP	Z EY N AH P
ZHANE	Z HH EY N
ZIAD	Z IY AE D
ZIAD(2)	Z IY AY EY D IY
ZIAD(3)	Z AY AE D
ZILAN	Z AY L AH N
ZION	Z AY AH N
ZISHAAN	Z IH SH EY AH N
ZISHAN	Z IH SH AH N
ZIYAD	Z IY AE D
ZOBIA	Z OW B IY AH
ZOE	Z OW IY
ZOEY	Z OW IY
ZOFIA	Z OW F IY AH
ZOHA	Z AA HH AH
ZOHAIB	Z AH HH EY B
ZOHEB	Z AA HH AH B
ZOHRA	Z AA R AH
ZOWIE	Z OW AY
ZOYA	Z OY AH
ZUBAIR	Z UW B AH AH R
ZUHAIB	Z AH HH EY B
ZULAIKHAH	Z UW L EY K AH
ZULEIKA	Z UW L IY K AH
ZULEKHA	Z UW L EH K AH
